,tx_date,tx_count,Tx_volume_Ether,tx_count_ERC20,Tx_volume_ERC20,Volume($),Market Cap($),DAU,CUM
0,2015-10-30,7941,1209372.484197744,3.0,2e-15,2429200,77401817,7501,7501
1,2015-10-31,7557,276417.8861926794,0.0,0.0,673892,68163368,7076,14577
2,2015-11-01,6915,145524.3736632436,0.0,0.0,588913,78530263,6516,21093
3,2015-11-02,6558,351890.3252358131,1.0,5e-16,1145200,73654327,6223,27316
4,2015-11-03,7399,595172.0165752954,30.0,8.001247646109999e-07,1907690,75434114,6973,34289
5,2015-11-04,7037,805279.2809739419,18.0,0.0003006000019211,3060340,66947930,6785,41074
6,2015-11-05,7498,344177.2381576182,12.0,0.0005102010106,1179840,66716645,7150,48224
7,2015-11-06,7882,938177.7125271261,0.0,0.0,913666,69004595,7096,55320
8,2015-11-07,10996,425968.4191117488,0.0,0.0,890187,69172171,7762,63082
9,2015-11-08,12413,896689.2152949413,18.0,2.00000863e-10,1021460,76614488,11494,74576
10,2015-11-09,7689,946972.7186752676,39.0,0.0021400000051648477,2045290,74537426,7346,81922
11,2015-11-10,8151,891132.5009798972,39.0,0.00019500000000000019,854581,69717801,7049,88971
12,2015-11-11,10217,301403.98011445114,27.0,0.00010500040002,1278580,59103443,7185,96156
13,2015-11-12,9534,280944.6797354017,5.0,0.0020049995999999997,806156,66880152,7202,103358
14,2015-11-13,7891,466140.02053751267,3.0,0.00500000000000012,543671,67529354,6863,110221
15,2015-11-14,7211,283617.9136551191,1.0,1e-14,372514,66410518,6872,117093
16,2015-11-15,7170,175558.45399726197,4.0,2e-05,411848,67745801,6887,123980
17,2015-11-16,7442,435998.2422889763,2.0,2.4000000000000003e-15,620945,69458011,7066,131046
18,2015-11-17,7145,1157255.4504056573,0.0,0.0,1145440,75392162,6854,137900
19,2015-11-18,7373,199011.47477591116,1.0,1e-14,681104,74320769,7079,144979
20,2015-11-19,8876,274435.5759725957,0.0,0.0,443528,71517342,6998,151977
21,2015-11-20,6348,194574.87131049743,2.0,2e-13,614335,69247998,6054,158031
22,2015-11-21,6822,134094.469887511,0.0,0.0,455976,73107357,6543,164574
23,2015-11-22,7083,256032.7116262586,0.0,0.0,372173,72523507,6811,171385
24,2015-11-23,8260,684591.9541215062,0.0,0.0,441875,70970606,6981,178366
25,2015-11-24,7152,393639.38337651425,0.0,0.0,524195,67487356,6843,185209
26,2015-11-25,7098,188350.23041391218,0.0,0.0,622991,64760707,6797,192006
27,2015-11-26,7278,970682.711394449,2.0,4.5000000000000004e-17,947473,66330892,7009,199015
28,2015-11-27,6639,679065.0324089762,0.0,0.0,403813,65135635,6268,205283
29,2015-11-28,6817,120693.88710113094,3.0,1.5000000000000002e-05,462464,68742122,6441,211724
30,2015-11-29,6853,190336.97666764294,1.0,5e-06,448358,65980042,6538,218262
31,2015-11-30,8986,235620.56009073614,0.0,0.0,784439,65589555,6510,224772
32,2015-12-01,6794,223148.3692149045,0.0,0.0,652857,65738067,6458,231230
33,2015-12-02,6502,294731.5263954783,1.0,5e-12,506307,61730775,6068,237298
34,2015-12-03,6971,221298.84468767713,1.0,1e-11,539969,61070307,6624,243922
35,2015-12-04,6898,167927.63539345708,16.0,0.00010000000031659402,241278,63189182,6378,250300
36,2015-12-05,6784,143950.6986104715,7.0,1.0042214e-11,232743,64895497,6418,256718
37,2015-12-06,9103,239353.02859054258,4.0,0.00010000000001400001,443608,62889050,8528,265246
38,2015-12-07,7141,451685.83183812804,6.0,1.000704e-12,520409,61084951,6847,272093
39,2015-12-08,6697,177353.65918141915,5.0,2.110002e-12,445903,61922409,6378,278471
40,2015-12-09,7001,245116.5830524136,1.0,5e-13,624221,59687098,6690,285161
41,2015-12-10,7444,216831.8417104069,9.0,2.5660500000000003e-11,369589,63342630,7005,292166
42,2015-12-11,8105,319169.5964985955,6.0,1.0001110100000001e-10,801072,70101842,7746,299912
43,2015-12-12,8205,485803.6230846128,3.0,1.00214997e-10,1376280,73686284,7830,307742
44,2015-12-13,7426,323458.1499101875,1.0,1e-12,273614,71894531,6984,314726
45,2015-12-14,15550,308723.0494532432,4.0,0.0001000015000001,563436,74947760,15043,329769
46,2015-12-15,21098,535185.628197709,4.0,1.1500000000000001e-15,578618,76568082,13510,343279
47,2015-12-16,10304,1458678.4433294176,0.0,0.0,320767,74858729,10000,353279
48,2015-12-17,9612,439455.2453767956,0.0,0.0,640765,71069938,9232,362511
49,2015-12-18,9032,237310.04037936102,0.0,0.0,300787,69538663,8503,371014
50,2015-12-19,9314,227874.55135007712,0.0,0.0,343535,68650439,9044,380058
51,2015-12-20,9879,205498.9026867638,0.0,0.0,472164,68356313,8843,388901
52,2015-12-21,12063,234202.7466664784,2.0,1.005e-12,549113,68143246,8997,397898
53,2015-12-22,21027,237641.76614454386,0.0,0.0,454249,65398932,20707,418605
54,2015-12-23,22740,143437.3800179474,4.0,3.0000000000000004e-05,334993,64957356,9348,427953
55,2015-12-24,13494,125581.49020075898,0.0,0.0,354646,65371538,10089,438042
56,2015-12-25,9521,68608.89794512316,0.0,0.0,187114,65931377,9297,447339
57,2015-12-26,10726,145241.32981655624,3.0,4.71e-15,425282,64758910,9165,456504
58,2015-12-27,21867,79395.38393075814,0.0,0.0,164565,64913919,10503,467007
59,2015-12-28,12368,441952.58033532806,1.0,1.1e-17,235134,64074279,10988,477995
60,2015-12-29,11358,286252.4402072391,2.0,1.5e-11,215742,66222901,10399,488394
61,2015-12-30,21767,215187.37229839744,2.0,5.0000000000000005e-17,604078,69196765,9213,497607
62,2015-12-31,10301,389547.03617148945,0.0,0.0,663994,70858023,9876,507483
63,2016-01-01,8233,344547.75662963034,0.0,0.0,206062,71980386,8006,515489
64,2016-01-02,9164,259240.00999005607,0.0,0.0,255504,71176658,8814,524303
65,2016-01-03,9258,370819.99349796807,0.0,0.0,407632,73843292,9019,533322
66,2016-01-04,9474,154125.47193275348,0.0,0.0,346245,72543707,9059,542381
67,2016-01-05,16430,1036291.1849078288,0.0,0.0,219833,72240974,11164,553545
68,2016-01-06,17074,261874.53527286416,1.0,1e-15,308791,72317149,12493,566038
69,2016-01-07,22075,350229.8290590733,5.0,1.4012000000000001e-12,647462,71667152,10557,576595
70,2016-01-08,10919,196294.99059642627,0.0,0.0,545600,75099809,10512,587107
71,2016-01-09,11793,210794.17218016024,7.0,5.01063e-11,226281,75128312,11005,598112
72,2016-01-10,10320,140901.8974584387,0.0,0.0,390888,76097646,9853,607965
73,2016-01-11,10893,504557.61877364863,0.0,0.0,1011920,80874514,10452,618417
74,2016-01-12,10862,990457.4541653133,1.0,0.0,2898760,86951446,10570,628987
75,2016-01-13,17665,423225.74264398176,1.0,5e-06,1005910,85775572,11590,640577
76,2016-01-14,10653,332500.04114495794,3.0,6.001e-14,751961,90714399,10192,650769
77,2016-01-15,9875,945389.3110590987,8.0,8.00000501043e-07,3910550,92149709,9508,660277
78,2016-01-16,10664,571218.0307613635,0.0,0.0,2462630,93117298,9618,669895
79,2016-01-17,9747,370959.2685284464,2.0,2.6e-14,1171150,101329330,8629,678524
80,2016-01-18,12916,2265938.496870146,3.0,6.67e-15,4278930,108912542,10055,688579
81,2016-01-19,13420,1240725.60949413,1.0,1e-17,2446740,104750746,9488,698067
82,2016-01-20,10610,600217.3158029309,4.0,1.0000008500000001e-09,2933220,117043472,10058,708125
83,2016-01-21,10734,495019.13781695056,3.0,1.01e-12,1614960,118743869,10225,718350
84,2016-01-22,13848,919024.7661309864,4.0,5.900020000000001e-13,1567240,114784065,9819,728169
85,2016-01-23,11025,1143853.7250894862,4.0,6.1e-15,7370980,150874912,10580,738749
86,2016-01-24,12798,1920659.6335564193,5.0,1.0000000000660002e-05,9669770,163819884,11342,750091
87,2016-01-25,17121,2139486.1873200466,2.0,1.5e-16,10739300,191276220,13374,763465
88,2016-01-26,16511,1445114.611804132,4.0,2.05e-14,13939200,174275656,13806,777271
89,2016-01-27,18747,1216512.1406424248,1.0,1e-12,6961080,182923580,15547,792818
90,2016-01-28,16765,921921.1823253087,1049.0,6.309949e-12,4903850,193551356,16195,809013
91,2016-01-29,16395,863482.3694084826,232.0,1.5751574999999992e-11,6662340,191198055,15423,824436
92,2016-01-30,14661,990010.500605252,13.0,5.046761e-12,3725080,187435391,14201,838637
93,2016-01-31,14166,1095129.4008277883,2.0,1.0000000001e-06,5847500,176834424,13655,852292
94,2016-02-01,14199,599953.3954943054,15.0,1.00000529958e-07,3994100,169654871,13709,866001
95,2016-02-02,14291,619268.0556974653,169.0,1.0003724381000005e-08,3451270,187200922,13251,879252
96,2016-02-03,14274,620367.681208657,24.0,1.1692080979999999e-09,3987750,194099730,13831,893083
97,2016-02-04,14371,329929.93471551023,20.0,8.000094800000001e-10,3552320,197953037,13671,906754
98,2016-02-05,15249,576484.8732191569,12.0,5.047e-15,2636700,195018592,14626,921380
99,2016-02-06,31418,234029.78767808338,9.0,5.6155549999999995e-12,1921240,194733892,13431,934811
100,2016-02-07,14264,895588.6721713973,21.0,1.0541551600000002e-10,7007060,227838892,13732,948543
101,2016-02-08,14719,1473331.9553023996,32.0,6.018996040000002e-10,9725690,244479014,14204,962747
102,2016-02-09,15517,1566591.205855035,20.0,9.900108340000001e-10,17954000,311075408,15047,977794
103,2016-02-10,17141,1936737.3786143998,13.0,1.0000029578000003e-08,28640400,341305129,16616,994410
104,2016-02-11,21440,1796888.5338249851,65.0,1.1746188810000022e-09,26408200,462770855,20496,1014906
105,2016-02-12,18109,2102560.7474572705,12.0,1.31904121e-10,23360800,427037697,17752,1032658
106,2016-02-13,19327,1292122.4267901871,5.0,1.0000500000008e-05,24218800,414729231,18698,1051356
107,2016-02-14,16624,919518.6556577692,12.0,8.00130186e-10,11226500,403647764,16250,1067606
108,2016-02-15,17159,732564.1388845443,42.0,1.17507677952e-07,13934200,407524960,16562,1084168
109,2016-02-16,17549,1299832.6007981263,23.0,2.03033126231e-07,15889100,332648533,16828,1100996
110,2016-02-17,19990,754017.3446627668,30.0,0.04000000200227952,15451000,289721943,16906,1117902
111,2016-02-18,16969,1126924.7874675633,36.0,2.9731077249e-08,17054000,339328346,16333,1134235
112,2016-02-19,18412,494083.5739067683,8.0,1.000023575e-09,7666320,365577845,17172,1151407
113,2016-02-20,16714,1192032.1260722594,33.0,2.721426675e-09,8631090,335088727,16232,1167639
114,2016-02-21,17119,477033.89785058773,18.0,3.4100324730000006e-09,6413550,359310563,16724,1184363
115,2016-02-22,18190,804469.0114547851,29.0,1.0020570176100001e-07,15056200,433798974,17554,1201917
116,2016-02-23,18482,1550284.322792968,42.0,2.008652130999996e-09,13380600,431598157,17389,1219306
117,2016-02-24,19540,2094714.2307884025,34.0,1.2882500000000003e-13,11426500,481995066,18141,1237447
118,2016-02-25,19503,922740.1095025749,38.0,2.9831853165999996e-08,21471800,471975064,19075,1256522
119,2016-02-26,21068,4011750.6959281806,46.0,2.315841784746324e+59,9526860,457966535,18059,1274581
120,2016-02-27,18981,2172699.7113433257,17.0,6.916790510000001e-10,8903210,497119698,18396,1292977
121,2016-02-28,19063,779346.2170521916,14.0,2.696592308e-09,9851660,500569665,18481,1311458
122,2016-02-29,20358,711512.3873095852,47.0,1.00200146231e-07,7648020,490556570,19258,1330716
123,2016-03-01,21778,1303682.8869513911,46.0,7.243917150000007e-10,23098100,592677993,21128,1351844
124,2016-03-02,23562,3598821.297713856,48.0,3.2349148899999986e-10,29130200,655748796,23100,1374944
125,2016-03-03,24837,2098541.1832251647,30.0,7.990051500137601e-05,40314900,720179291,24355,1399299
126,2016-03-04,24287,1511185.4902133483,143.0,1.0201151836e-08,35520100,806593727,23598,1422897
127,2016-03-05,27115,2863789.9643404107,18.0,1.1220007211000001e-08,56439600,853205226,26374,1449271
128,2016-03-06,27661,1613121.6804061641,27.0,1.0008016451e-08,39112000,882886756,24892,1474163
129,2016-03-07,23271,1478976.1037802924,38.0,2.7177932280000006e-09,34085100,741166643,22554,1496717
130,2016-03-08,24105,2147056.4451147527,68.0,8.023302401100002e-08,25524300,764269545,23540,1520257
131,2016-03-09,24557,1124806.2840957537,53.0,1.0110469148e-08,27540500,923733301,23939,1544196
132,2016-03-10,24814,857326.4009551007,41.0,5.0023403170000025e-09,26851500,877988473,24375,1568571
133,2016-03-11,23124,940527.0899229049,73.0,1.0226465670999992e-08,21002700,861012043,22716,1591287
134,2016-03-12,27887,1527253.5600615114,64.0,2.5158451800999947e-08,48957300,1051728778,27423,1618710
135,2016-03-13,28127,1982750.3024187824,36.0,1.4506156729500005e-07,43915100,1125287882,27748,1646458
136,2016-03-14,28528,1632667.4623933544,40.0,5.0000302218079036e-05,58385100,968384041,27930,1674388
137,2016-03-15,29273,1295920.7408650166,55.0,2.117341800000001e-11,28404500,1012119266,28744,1703132
138,2016-03-16,27596,1114815.341716587,28.0,1.0447557239999993e-09,24335500,974447125,27134,1730266
139,2016-03-17,33531,1744044.2521900712,45.0,1.8214799870000001e-09,41650600,865792703,31202,1761468
140,2016-03-18,31821,2355802.0699841604,39.0,1.645402215e-09,53956800,859618881,31210,1792678
141,2016-03-19,34779,792160.4371595263,29.0,3.710086429000001e-09,26735700,823422650,28113,1820791
142,2016-03-20,32447,555717.1503842355,66.0,4.424242424242424e+24,17651100,807256577,28906,1849697
143,2016-03-21,32511,891507.1325508524,333.0,5.051068477133001e-06,28572600,928428770,31267,1880964
144,2016-03-22,32890,685522.4339517412,3074.0,100000.0000002476,19730300,883434497,31868,1912832
145,2016-03-23,31786,573278.5860859633,908.0,2.1429913132899994e-07,19353200,973296475,29791,1942623
146,2016-03-24,36947,954218.0113380804,4913.0,2.603802335024796e-05,26081800,881027910,33635,1976258
147,2016-03-25,36762,554298.1072411612,2164.0,8.105446246612133e+59,13782000,842804289,29860,2006118
148,2016-03-26,36646,333485.1095440226,5510.0,3.473762677119486e+59,9425480,861261383,28176,2034294
149,2016-03-27,29974,1173358.4683441655,515.0,7.167085715800005e-08,16744800,818048967,29609,2063903
150,2016-03-28,33613,793344.9730820599,4229.0,4.319151296480923e-06,23188300,916272916,33186,2097089
151,2016-03-29,33915,1292988.3102298896,686.0,16.180340010012436,17684200,915917612,32068,2129157
152,2016-03-30,36767,1365956.2682918406,2760.0,9.244562691159904e-07,19351200,939593767,35497,2164654
153,2016-03-31,32259,898131.2815246179,571.0,8499.991600097545,14966700,896764774,30692,2195346
154,2016-04-01,33320,382658.4692324789,3262.0,0.0045559679315114315,11373100,917590806,32722,2228068
155,2016-04-02,29358,376118.7547938757,485.0,1.352069686069999e-07,8682620,912861404,28777,2256845
156,2016-04-03,29588,218410.5780975296,523.0,1.5106962673200014e-07,5580550,914757199,29211,2286056
157,2016-04-04,34907,439288.38632318,3421.0,1.049731826517983e-06,9599070,878817015,33786,2319842
158,2016-04-05,39173,689157.4018175405,6172.0,1.5225393308800064e-07,20557300,822498173,30619,2350461
159,2016-04-06,32078,588899.4131824443,1148.0,1.7480202153640018e-06,16997100,842318789,31374,2381835
160,2016-04-07,31893,724080.540985818,2164.0,4.53840274111398e-06,13464500,794097554,31362,2413197
161,2016-04-08,34010,549948.0419011634,4101.0,1.2993837739969784e-06,14660600,766797893,33549,2446746
162,2016-04-09,31923,1307076.0203213228,1204.0,48557.00000032552,16194800,722193576,31465,2478211
163,2016-04-10,32237,1180640.220736079,516.0,1001.0000000894421,42613400,705565730,31714,2509925
164,2016-04-11,30327,623593.1465548826,468.0,58578.33333238513,15138100,682735835,29903,2539828
165,2016-04-12,34673,1090443.0935182874,2264.0,27023.140964986836,23190100,588069234,32234,2572062
166,2016-04-13,36051,1138001.2788851243,1573.0,435.82688986032025,31403300,635899507,31265,2603327
167,2016-04-14,34781,943925.2889141517,1247.0,5002.244349740713,13590700,663262434,31621,2634948
168,2016-04-15,34959,591871.9418893863,4724.0,145.75248051466025,12179000,652099781,30776,2665724
169,2016-04-16,30483,433480.19359753956,251.0,356.80424174715483,9888460,681383666,30060,2695784
170,2016-04-17,40203,824811.6497199553,214.0,117.84931103122759,24619600,737045140,31705,2727489
171,2016-04-18,33513,638575.5220348766,1366.0,3500.098710517638,21084100,715710193,33074,2760563
172,2016-04-19,32622,408617.4080855161,1101.0,1.494450544500009e-07,12899100,690548723,32246,2792809
173,2016-04-20,32944,674715.7760337677,1098.0,52.94577963781319,15634700,671081004,32057,2824866
174,2016-04-21,37181,473341.50039064896,888.0,9.882545992371984,13355400,642511137,31563,2856429
175,2016-04-22,31678,754279.1965927382,242.0,4010.9883864775557,13309300,620481616,30843,2887272
176,2016-04-23,31845,1014163.6194503262,177.0,0.000665561188252095,14565200,658310822,31291,2918563
177,2016-04-24,34046,375281.72660883545,2139.0,7.156811245119944e-07,10786400,635274078,33356,2951919
178,2016-04-25,35430,712837.6066839941,2977.0,432.027479403192,18239900,600026226,32031,2983950
179,2016-04-26,32582,1163553.4159794801,776.0,39.58672397521151,17667300,587763650,31765,3015715
180,2016-04-27,33847,781767.4349658525,371.0,18839.19674907534,19254500,616849026,32863,3048578
181,2016-04-28,34343,778516.1864909693,1424.0,20970.79276103598,11576000,570380061,33365,3081943
182,2016-04-29,37332,608142.8699598198,1292.0,1360.9794757071538,8762080,593261114,35474,3117417
183,2016-04-30,45769,2708036.281065341,379.0,599.1148932489872,36573300,701473017,40199,3157616
184,2016-05-01,39578,1765351.0509876008,1385.0,1335.790856980515,16713800,704335725,37418,3195034
185,2016-05-02,41748,1918795.907882979,243.0,13.117971428054245,41019200,809492236,40625,3235659
186,2016-05-03,37821,1410363.233617694,315.0,4269.180022814202,21463900,741932869,36699,3272358
187,2016-05-04,37484,1099827.7022068172,1244.0,1000000006575.8146,17622400,750396087,35809,3308167
188,2016-05-05,38707,1104747.9119427814,414.0,1611.7080194521895,18296200,783576042,36056,3344223
189,2016-05-06,41271,2047648.5996017463,4073.0,33.55900383609316,21510600,745638476,36957,3381180
190,2016-05-07,35864,1521157.8162735952,355.0,1007358.5656827654,10806500,747838842,34629,3415809
191,2016-05-08,40063,1423875.3703716188,1422.0,271.93604447695685,15031000,757112769,38551,3454360
192,2016-05-09,38560,2029472.407365964,376.0,1677.5702670822968,13085300,742621899,36897,3491257
193,2016-05-10,40684,2068142.4329983103,423.0,5916.513114110777,9321790,748013846,39343,3530600
194,2016-05-11,40811,3053543.5829318683,349.0,10524.240570759272,15267500,799045673,38630,3569230
195,2016-05-12,45002,3266440.814112004,1637.0,1012.970302955082,24137700,804287196,42613,3611843
196,2016-05-13,47739,8129691.546387801,278.0,10865.835947436157,31276900,840514936,45893,3657736
197,2016-05-14,45745,5915021.886388864,1513.0,677.5120653228907,18808000,819487228,44215,3701951
198,2016-05-15,43073,1496096.0791421589,244.0,107.24364910661582,9218400,797607883,38497,3740448
199,2016-05-16,37424,1492298.613641923,1216.0,290.7243977683059,29079900,894750992,36190,3776638
200,2016-05-17,40309,1323418.8647026734,329.0,9668.254821672417,37198700,977439936,38734,3815372
201,2016-05-18,46033,1820390.7276589845,1040.0,4333.322753910915,65389900,1086834954,44409,3859781
202,2016-05-19,44523,2661787.2434266154,611.0,354.442477919354,53757500,1184385765,42037,3901818
203,2016-05-20,45177,2262816.283780718,234.0,37042.019052179225,50544100,1093879433,41091,3942909
204,2016-05-21,43621,997790.6921392232,1085.0,600.0000052688404,24648400,1124761560,39933,3982842
205,2016-05-22,38895,672278.621404995,172.0,558.3809004572122,17938900,1146979484,36897,4019739
206,2016-05-23,43806,1252185.823338655,178.0,309.05350167353447,23842800,1081207347,42277,4062016
207,2016-05-24,42911,1762896.971935422,272.0,185.09264301809205,41560600,1023046506,41421,4103437
208,2016-05-25,46443,1716758.6096188189,251.0,3384.291001258586,27444700,1006875564,41481,4144918
209,2016-05-26,51147,1282277.6847744263,273.0,110.08800068909702,20764000,999589702,47927,4192845
210,2016-05-27,49006,2615143.025828509,344.0,34.42704507581039,57496400,908715671,45816,4238661
211,2016-05-28,70148,2212896.2274907203,11106.0,1973725.0542928793,47274800,957134590,47040,4285701
212,2016-05-29,45890,1005321.0666053722,3907.0,817579.4610301858,28598400,994349367,39204,4324905
213,2016-05-30,42927,1012553.3106388998,2340.0,331225.58176607866,14733800,1024940354,38054,4362959
214,2016-05-31,44386,1021195.4119184696,1737.0,307863.0423595833,42433400,1134278934,39462,4402421
215,2016-06-01,42221,787935.5142751248,1425.0,263172.65521084,22471300,1128621280,37388,4439809
216,2016-06-02,39666,499552.62835835636,1033.0,90974.94181979736,10477200,1107823663,37224,4477033
217,2016-06-03,39834,626480.4621054234,981.0,163695.5204197229,22981500,1117035879,37590,4514623
218,2016-06-04,37875,465208.80750860093,861.0,140143.92598355174,15792400,1108902326,34596,4549219
219,2016-06-05,37896,455059.1243848559,952.0,91450.5229985999,11088400,1128276672,35699,4584918
220,2016-06-06,38957,480224.0054113277,966.0,151994.3997405421,8720400,1125426017,36354,4621272
221,2016-06-07,46141,1001265.1114374404,1132.0,240134.58240629782,21421600,1172565099,37123,4658395
222,2016-06-08,40433,2152104.523402545,1651.0,121614.37065641521,16941800,1165411416,37828,4696223
223,2016-06-09,39854,462236.82736007276,1210.0,150393.92490763895,8256830,1164331165,36866,4733089
224,2016-06-10,40145,895193.2420679684,1132.0,113036.57918091807,11312900,1125141726,36728,4769817
225,2016-06-11,36901,527070.6268577712,1145.0,275707.9651191774,12176500,1148494818,33533,4803350
226,2016-06-12,42581,1100016.7044945534,1039.0,184086.50576987758,38210300,1274609697,39369,4842719
227,2016-06-13,46185,1181080.007350363,1705.0,1.157920892373162e+59,38023400,1425681023,40808,4883527
228,2016-06-14,50335,1414674.4375437626,2235.0,535832.191647141,64412200,1530808958,43541,4927068
229,2016-06-15,43251,918147.1312206829,1625.0,104968.03749187833,19393400,1487730475,39988,4967056
230,2016-06-16,43392,1482193.1429814165,1338.0,160066.8770283962,38531000,1669490450,38374,5005430
231,2016-06-17,66558,4206872.8167635435,19035.0,5592818.605059607,199408000,1247381862,51144,5056574
232,2016-06-18,63083,5143917.883306614,4091.0,1542789.3431018395,133937000,919553125,47294,5103868
233,2016-06-19,51035,1814669.224236719,2018.0,649411.3386675336,69783600,993283674,43982,5147850
234,2016-06-20,47118,2615166.258152628,1661.0,539293.8459500346,58143600,961613934,39638,5187488
235,2016-06-21,47323,1787237.466468546,4811.0,12453306.26604522,69245600,1081206507,41982,5229470
236,2016-06-22,48615,2063359.701840382,3236.0,13186544.098381741,96994096,1064441461,42614,5272084
237,2016-06-23,41908,1776914.5357601542,806.0,161174.40066949706,30806400,1112111665,38349,5310433
238,2016-06-24,45331,1123372.4675116611,902.0,189791.9341671521,33332900,1165908840,39535,5349968
239,2016-06-25,36684,1257452.2185218835,662.0,208194.94816612854,15383100,1162367709,34406,5384374
240,2016-06-26,41613,622684.0248495798,1023.0,432181.62753918115,14747600,1127593040,38910,5423284
241,2016-06-27,39663,652682.2952258013,811.0,338975.3872498663,10994700,1130782777,37048,5460332
242,2016-06-28,43089,1559259.9753595053,989.0,346970.1008920933,43436600,992040075,40076,5500408
243,2016-06-29,49897,1267924.1068201791,909.0,331807.1556856895,26982800,1027934140,38382,5538790
244,2016-06-30,63952,868829.9303407904,707.0,255873.9569321619,15801300,1016130567,38002,5576792
245,2016-07-01,40085,859851.224395839,552.0,64635.12231599586,17236500,995164390,37380,5614172
246,2016-07-02,39257,462883.1622665779,616.0,43780.44066387274,8987070,989751702,37574,5651746
247,2016-07-03,39757,514047.3799708359,578.0,103842.39596426678,10588700,956815986,37250,5688996
248,2016-07-04,39950,1170339.9083969558,625.0,2093564.563338382,12943500,936840410,37099,5726095
249,2016-07-05,39270,3599995.986842387,836.0,21059793.46775199,45526900,866971680,36482,5762577
250,2016-07-06,37900,1061768.1708077746,540.0,68587.87445140294,18137300,860571470,35870,5798447
251,2016-07-07,40433,985951.1102504568,509.0,360500.2459748659,15407200,826607193,38386,5836833
252,2016-07-08,42506,690053.5462968679,542.0,239604.01140868163,20039800,932056896,38402,5875235
253,2016-07-09,40410,592166.1812990519,851.0,243955.5479898515,17254800,897316512,36814,5912049
254,2016-07-10,39358,664294.3792441862,403.0,313375.6808727026,5479240,896201853,37285,5949334
255,2016-07-11,38582,806503.7208227257,886.0,16489697.8733057,13098000,856538034,36720,5986054
256,2016-07-12,40811,865991.6744551824,527.0,231251.6553154074,11127700,861548337,37692,6023746
257,2016-07-13,35740,942434.1598654628,548.0,748762.8789151956,6715660,860607720,33623,6057369
258,2016-07-14,42809,929952.789833544,2651.0,1291048040.9925036,23621900,943973547,39373,6096742
259,2016-07-15,41110,3906606.3410737407,915.0,488070.7185948157,26838900,980299532,38181,6134923
260,2016-07-16,38062,781954.2407737238,888.0,1.1111111111111328e+19,10445700,956165958,35537,6170460
261,2016-07-17,33914,764327.8602596715,519.0,213173.60844968833,17921600,915977475,32643,6203103
262,2016-07-18,39198,2860574.6948209703,1668.0,1.157920892373162e+59,15931900,906133047,35686,6238789
263,2016-07-19,44184,9752265.753399426,802.0,14898537.486571224,21730000,954516828,41325,6280114
264,2016-07-20,50631,14048781.522859877,2763.0,6360279.680525152,60226100,1023222624,41363,6321477
265,2016-07-21,44882,1759381.0451980438,2156.0,1342832.4321174892,24636900,1040082090,39088,6360565
266,2016-07-22,48458,3039706.5099816155,1530.0,615976.0741498803,74779504,1205898353,43484,6404049
267,2016-07-23,45006,2630014.602210412,1334.0,510190.8737311825,32489700,1176571490,40078,6444127
268,2016-07-24,58215,12819164.313000353,1918.0,1273950.891571152,77750800,1049423539,53815,6497942
269,2016-07-25,54856,9812906.815101048,1432.0,984068.3819401904,36673800,1139304848,50674,6548616
270,2016-07-26,61930,20796513.816904057,1227.0,648633.2490079529,94428800,987619812,58457,6607073
271,2016-07-27,53035,12472133.651370538,1055.0,2674640.134724873,58278800,1069044527,46257,6653330
272,2016-07-28,48555,7641593.057245325,5766.0,270105391.3885369,24603900,1058813509,45616,6698946
273,2016-07-29,47243,5340728.1869723825,2649.0,3521879.3384587546,14082300,1055182413,43060,6742006
274,2016-07-30,42011,3765261.3426692896,1999.0,3063824.3572411486,9047810,1028064459,39386,6781392
275,2016-07-31,48749,3624010.5141531113,561.0,162707.11366441674,25441400,980174931,43315,6824707
276,2016-08-01,45978,5443307.268995081,826.0,2716570.2123876056,23999500,903408507,44072,6868779
277,2016-08-02,49041,10161622.761129934,851.0,594745.0226464208,88803296,725809584,45686,6914465
278,2016-08-03,49475,8758068.282896804,502.0,486630.935683762,53979400,850578647,46556,6961021
279,2016-08-04,46761,3683826.2857799153,524.0,116651.42038279132,38151400,912823135,44829,7005850
280,2016-08-05,43212,4194932.343117477,430.0,78574.60971064532,15487900,903471435,41683,7047533
281,2016-08-06,41487,1812441.4640715958,317.0,23724.42773373073,16712600,900151688,40409,7087942
282,2016-08-07,42955,2099323.0096954047,983.0,7180702.011055352,16551000,903026897,41305,7129247
283,2016-08-08,42984,2127579.745003418,13398.0,153575439.59780002,14956700,931013385,41108,7170355
284,2016-08-09,47057,3168844.1251290794,1675.0,36074.046370047596,36656600,1014113084,44720,7215075
285,2016-08-10,46290,4822478.51280524,566.0,110571.30686303902,28096300,1006130318,42754,7257829
286,2016-08-11,48171,3893149.456205361,407.0,21308.305860497818,17505000,969030731,45995,7303824
287,2016-08-12,44400,2296776.6616665307,599.0,146628.3524685913,13690100,976670290,40680,7344504
288,2016-08-13,41088,1996859.5275213923,308.0,22116.484708122072,7539490,959859186,38545,7383049
289,2016-08-14,40577,1610919.1656854236,280.0,494662.80029455264,8680160,928985642,39647,7422696
290,2016-08-15,42302,1432683.9845249823,522.0,2564199.4458922567,7500840,931306989,40805,7463501
291,2016-08-16,48949,933870.7654559638,1286.0,22373.177758478923,7051510,925130735,42758,7506259
292,2016-08-17,44867,1765481.1780652606,327.0,35342.643252563284,8833760,893343056,41289,7547548
293,2016-08-18,47799,1185765.253793605,226.0,77495.5644638712,6935800,893970119,42285,7589833
294,2016-08-19,42948,1025740.0952162428,323.0,25975.27868661996,5390850,893697474,40963,7630796
295,2016-08-20,41318,1549805.772811578,276.0,38031.74151890648,7443540,935523908,39163,7669959
296,2016-08-21,42543,3552725.023020394,495.0,28778.525872592334,4355660,930217061,40783,7710742
297,2016-08-22,44250,2235034.2291028798,674.0,1971186.9172556598,6588920,925725247,40879,7751621
298,2016-08-23,48430,4483516.598773596,729.0,97674.54696031229,6489380,918563334,44282,7795903
299,2016-08-24,46821,1000855.2357822439,575.0,359844.8574696509,4423420,919368975,41574,7837477
300,2016-08-25,49868,924606.8930583097,494.0,81916.01212047056,8552380,946508890,43848,7881325
301,2016-08-26,47292,1957576.4010493609,520.0,56887.324985965606,5857850,941701926,41151,7922476
302,2016-08-27,47938,963855.9132431883,395.0,14458.49369087248,15108400,929789646,42352,7964828
303,2016-08-28,42607,829801.8328832616,528.0,33729.727177966495,5303040,911883241,41039,8005867
304,2016-08-29,45510,1192352.638064406,378.0,44084.58147916238,8130540,916781161,40322,8046189
305,2016-08-30,46979,857699.5765793627,347.0,25778.953577018816,7221260,937596563,41645,8087834
306,2016-08-31,45846,1092590.1744181837,383.0,38427.89340344373,11073700,975003119,43571,8131405
307,2016-09-01,47491,1982139.408988366,362.0,33023.99490991813,24051500,1002322694,44401,8175806
308,2016-09-02,55413,1755148.4328126488,621.0,36419.89306746214,9368300,1012583470,42343,8218149
309,2016-09-03,44792,1250659.101209406,267.0,1000000000072458.6,13358800,983336326,41831,8259980
310,2016-09-04,48128,1483693.36638743,325.0,20040366.824939,7220550,977118527,41121,8301101
311,2016-09-05,42667,813317.2991654195,351.0,900364.0120008823,5724100,980599518,40905,8342006
312,2016-09-06,49102,967106.7528360183,707.0,424601.7586062227,6346330,978635238,43027,8385033
313,2016-09-07,48701,881275.925898267,403.0,73385.95302742487,6115050,967186182,39668,8424701
314,2016-09-08,55970,1516148.5812751628,436.0,51726.07918647581,11535000,950629714,45729,8470430
315,2016-09-09,53918,695219.8037543909,276.0,85269.85528034042,6109200,976718524,43633,8514063
316,2016-09-10,42875,669012.0442428626,275.0,61501.61119207852,7220300,1020331771,40623,8554686
317,2016-09-11,43345,845338.1307568008,286.0,29170.918319576496,8791180,976259356,42043,8596729
318,2016-09-12,45123,929510.3715145314,501.0,49056.3099911503,7478080,998057810,42000,8638729
319,2016-09-13,42591,957066.83331205,417.0,81984.56731222743,11704300,1000535934,40650,8679379
320,2016-09-14,53859,753057.5630659572,508.0,376180.7438910849,5694820,1001301306,43892,8723271
321,2016-09-15,52622,616806.4722426228,485.0,33894.834934010236,7309090,1002844845,43181,8766452
322,2016-09-16,57532,2269619.720574614,621.0,88337.9482434134,17421500,1055235487,46322,8812774
323,2016-09-17,46882,799631.4112635849,977.0,21040.40411432222,7446610,1067645133,42576,8855350
324,2016-09-18,37893,1566170.9148846718,302.0,1e+59,22433300,1045462817,35807,8891157
325,2016-09-19,40505,921963.2663392439,281.0,24497.35992403784,13838800,1109717807,39523,8930680
326,2016-09-20,54067,3686277.587217347,1039.0,31460.552059969963,31929100,1214629780,50727,8981407
327,2016-09-21,44549,4045139.3334809467,1322.0,85910.60478394512,28645000,1159365902,40730,9022137
328,2016-09-22,52657,1886796.894459742,310.0,13425.331178330556,27382800,1115922936,37458,9059595
329,2016-09-23,35219,2046385.987289577,207.0,33179.05124511522,9166430,1123430818,33692,9093287
330,2016-09-24,43418,1339246.162651529,243.0,22245.0812593041,9824880,1085651021,37447,9130734
331,2016-09-25,38713,2487747.411083099,398.0,76950.49446949796,5283440,1104901553,36906,9167640
332,2016-09-26,43514,1451513.3938065523,188.0,8074.390627323544,7213070,1081884909,39690,9207330
333,2016-09-27,46817,1133062.7059483607,290.0,103498.0229300115,6831070,1105565483,37738,9245068
334,2016-09-28,42797,2494171.867696614,311.0,35509.1959862531,10239000,1120893441,37245,9282313
335,2016-09-29,40416,2111756.6327845296,370.0,120894.98257139263,5990630,1104310043,38588,9320901
336,2016-09-30,35836,912957.3866649267,291.0,258050.96870994024,5950840,1117517388,34318,9355219
337,2016-10-01,53076,823595.5862333949,221.0,19618.35139359938,6331160,1113568557,39107,9394326
338,2016-10-02,51105,1799231.0948806936,437.0,115408.57657057159,4079660,1116323115,41830,9436156
339,2016-10-03,47672,610448.3333152606,725.0,25473.049282208267,7458320,1138142255,39548,9475704
340,2016-10-04,56662,702214.0495037744,5875.0,14672588.892965393,8348280,1123727868,28014,9503718
341,2016-10-05,41719,1040469.2604035812,2196.0,1506242.946762617,9881370,1103736600,30202,9533920
342,2016-10-06,36826,931642.9031123373,1455.0,1008800.1374510371,12044800,1088798918,29656,9563576
343,2016-10-07,43708,936093.3696202524,1056.0,1084602.0344593797,8933050,1073405275,35574,9599150
344,2016-10-08,37690,1051607.2200531543,826.0,623180.3978665922,11611200,1035883228,34100,9633250
345,2016-10-09,43940,2586241.94368635,729.0,513679.79735678225,7208480,1022264082,40441,9673691
346,2016-10-10,44940,2585173.485735905,896.0,414004.46208868676,10809200,997363895,41160,9714851
347,2016-10-11,41053,2300404.978869045,923.0,221850.2062835208,11727700,1000308761,35313,9750164
348,2016-10-12,30002,2628589.7390222326,631.0,177709.16660616655,9694640,1013248317,21971,9772135
349,2016-10-13,32244,1020347.2453409972,200.0,108961.08331435439,8665190,1016169767,17151,9789286
350,2016-10-14,42006,2634605.5223157033,254.0,130391.2278076948,4333510,1014456176,30611,9819897
351,2016-10-15,33662,1160067.5580472364,104.0,168919.3680300017,4991840,1018682988,31250,9851147
352,2016-10-16,34990,1599121.894653913,134.0,70826.29386810049,3617280,1016373308,31163,9882310
353,2016-10-17,38136,1834626.8534859463,457.0,194204.28555675622,5724440,1021302744,33955,9916265
354,2016-10-18,51898,2863401.4454111946,522.0,153920.47211853345,18864200,1071362741,43992,9960257
355,2016-10-19,38497,1061113.4312086636,1807.0,2.315841784746324e+59,10576200,1023599502,28562,9988819
356,2016-10-20,43438,726630.8204311669,486.0,150990.08568940332,8170760,1030522234,38344,10027163
357,2016-10-21,57780,620149.923215915,3025.0,184298.4434132115,5676920,1037420190,53009,10080172
358,2016-10-22,37772,501849.6035354874,726.0,85152.28978081583,7583820,1028949804,35914,10116086
359,2016-10-23,35364,432875.2366216041,585.0,94589.70981930186,5774660,1026301229,34250,10150336
360,2016-10-24,52547,651665.8311965264,2241.0,200067808.96839926,5739690,1020971991,38668,10189004
361,2016-10-25,47610,1105547.928124887,2498.0,9637703.825631492,19316000,973991742,37011,10226015
362,2016-10-26,45158,931707.3989510776,1735.0,6366376.600779913,10221800,984429110,37619,10263634
363,2016-10-27,44353,926250.0420584867,2031.0,2986301.153484381,13255400,982033774,37645,10301279
364,2016-10-28,41522,1541015.8985237852,3030.0,2455951.3515690207,13971500,946972469,37264,10338543
365,2016-10-29,40011,1868453.1378945399,3665.0,1058892.2425575333,27070400,892565736,35352,10373895
366,2016-10-30,39435,2428233.0622770865,2886.0,1318705.7457427653,16694900,956007454,33657,10407552
367,2016-10-31,45031,1242748.236853404,1013.0,1110057.5883172308,13393900,940578264,41296,10448848
368,2016-11-01,49025,2891074.926021144,5504.0,851970.4521538983,22901300,921057444,39462,10488310
369,2016-11-02,43519,4310501.0253933985,774.0,1089748.3649377364,11691700,920236997,38457,10526767
370,2016-11-03,42346,9954121.622508442,636.0,996520.5496238971,15228600,924716659,37875,10564642
371,2016-11-04,32572,1198615.6738513915,428.0,585613.0437756283,9958040,949862035,29818,10594460
372,2016-11-05,37690,864690.7160311491,465.0,393141.91680346185,5502670,942653972,34971,10629431
373,2016-11-06,34391,514902.5404536233,396.0,515724.17722091905,5688710,931947467,31928,10661359
374,2016-11-07,41941,641514.8362256737,470.0,566192.0052953423,5992480,926761430,38548,10699907
375,2016-11-08,41569,675989.1202939193,535.0,364395.1710822541,6258150,929246807,38300,10738207
376,2016-11-09,40517,2036813.5296422895,559.0,641040.3800399238,14606600,914292103,37407,10775614
377,2016-11-10,40164,1021861.3255187451,478.0,428975.124064747,4253980,903380024,35079,10810693
378,2016-11-11,41070,3766389.823659876,1358.0,1127754453.5133047,6056300,883565427,36260,10846953
379,2016-11-12,40882,1243314.241259823,979.0,18601643.631267205,10052500,848509382,36755,10883708
380,2016-11-13,43673,1266573.819270195,1492.0,11693346.256788777,8227770,868038290,38637,10922345
381,2016-11-14,43876,534398.4059907255,1731.0,1075003950.1101599,3573250,856753361,35919,10958264
382,2016-11-15,45330,1034779.4704251963,1374.0,17445096.53938338,6557550,878653067,38158,10996422
383,2016-11-16,41684,1081803.5381694331,1053.0,21768447.968962885,9533550,865349966,35956,11032378
384,2016-11-17,40738,3213637.2539063254,764.0,22930212.709360987,6984700,859814328,35061,11067439
385,2016-11-18,43785,1081771.1099401212,738.0,7133236.043268935,10816100,815806832,37640,11105079
386,2016-11-19,39289,860996.2891813536,613.0,6977242.579253989,5186540,832183861,35010,11140089
387,2016-11-20,42125,639717.7362465356,702.0,1130771601.1118681,5173420,825305262,36836,11176925
388,2016-11-21,42735,661636.2874426466,740.0,37219215.86124108,3663210,829190391,35981,11212906
389,2016-11-22,53585,2589149.7276508342,2699.0,16809324.380813163,11284400,854053528,46984,11259890
390,2016-11-23,64289,2437876.2112481557,439.0,21625599.883966196,4812310,849020680,59510,11319400
391,2016-11-24,36861,839941.5745277624,321.0,57442662.02015834,15987800,796538442,31845,11351245
392,2016-11-25,58075,1520448.63265815,342.0,4230460.816098987,7669720,811553949,45339,11396584
393,2016-11-26,40804,703597.9229588622,1022.0,13903801.048100099,3505990,805474198,31522,11428106
394,2016-11-27,44449,712634.5779755565,320.0,8427054.27986381,8707660,777313922,32137,11460243
395,2016-11-28,48388,797083.5631727165,632.0,5146486.870481511,6046890,753971438,34698,11494941
396,2016-11-29,47036,1318093.4465107562,1571.0,7627534.584550064,17000400,706651179,33335,11528276
397,2016-11-30,39178,1186558.3075930623,578.0,20593239.11714099,10626600,742664775,32063,11560339
398,2016-12-01,37121,1041823.788973421,586.0,2033798.981209843,5882340,731254342,31094,11591433
399,2016-12-02,41642,3315448.2339809565,1701.0,5358906.3108269805,18579800,671587252,34475,11625908
400,2016-12-03,41357,4826361.810119378,413.0,3201431.120044184,12112100,685808136,34851,11660759
401,2016-12-04,39643,1692376.12803265,460.0,5248902.091710181,8450790,644685715,34396,11695155
402,2016-12-05,41613,3645521.4245361094,805.0,2767618.0142444423,17344500,591026579,34693,11729848
403,2016-12-06,48200,6261379.713593418,1055.0,5667922.056764082,50671200,682013454,39334,11769182
404,2016-12-07,41757,2444217.808660409,4554.0,6438520.888131632,22229600,726702380,33299,11802481
405,2016-12-08,39587,2505469.338694138,749.0,14075436.22179116,16042700,713877391,34283,11836764
406,2016-12-09,41444,2526973.0813581245,682.0,1442613.399951142,12916300,732836297,36227,11872991
407,2016-12-10,40564,1412928.8131352388,1920.0,3774253.1970553896,8108370,705254561,35545,11908536
408,2016-12-11,39164,1947033.860127855,812.0,1739844.5422229716,5545500,711457159,34182,11942718
409,2016-12-12,38741,1064641.090299727,712.0,3427884.816380834,9119700,740255866,34887,11977605
410,2016-12-13,44664,1107648.450207733,1160.0,8165906.35013533,4486190,731892846,35113,12012718
411,2016-12-14,47294,1056565.1707351473,2410.0,12219298.610912846,7337220,718460239,35501,12048219
412,2016-12-15,46102,2122065.6452937294,1641.0,5587612.0054131,13184400,680740349,35578,12083797
413,2016-12-16,43953,1419768.3782134226,615.0,929041.9457043209,5178610,683575806,36069,12119866
414,2016-12-17,39442,3105913.6352558583,476.0,4007593.8968840884,8502620,685426528,33328,12153194
415,2016-12-18,36640,2162526.4047291283,557.0,3163664.3307016036,5890020,684696555,31382,12184576
416,2016-12-19,45599,1382611.794069229,2228.0,4790987.052791161,5894760,665654987,37573,12222149
417,2016-12-20,44241,1392311.6077272557,999.0,3690629.293368448,6313550,667309961,36334,12258483
418,2016-12-21,50793,2078891.8661526807,5382.0,6282421.0672327215,9393550,689718972,37251,12295734
419,2016-12-22,55173,3335131.8671183414,3739.0,4840346.570761228,16376700,661247899,43180,12338914
420,2016-12-23,44391,6254156.559423474,1924.0,5512943.492098666,19613100,624956487,36804,12375718
421,2016-12-24,37757,2353323.496116354,550.0,2081242.2178191703,7626020,633871896,33351,12409069
422,2016-12-25,36601,1059861.9627464483,565.0,5448349.374568899,8671840,626189631,31954,12441023
423,2016-12-26,34565,831211.1048084664,636.0,4179407.2922327826,5836810,635060699,30691,12471714
424,2016-12-27,42370,1416637.4838577197,2865.0,7693243.4635777995,8778610,626268701,33494,12505208
425,2016-12-28,43386,2901221.365024724,1466.0,29558785.81564412,17453300,657011884,34330,12539538
426,2016-12-29,46546,4591047.8363189,1917.0,4285512.715336042,27543800,724028107,36350,12575888
427,2016-12-30,44561,3282626.24263357,2032.0,7132327.902827721,13909900,713433620,34505,12610393
428,2016-12-31,41220,6360384.357325805,568.0,2408908.899626216,9066800,696993600,35056,12645449
429,2017-01-01,38730,1818691.001820934,489.0,7572363.541018775,14731700,715049208,33383,12678832
430,2017-01-02,39652,2857298.639950842,683.0,6275995.025558867,14579600,733331654,33296,12712128
431,2017-01-03,45883,5067349.112224574,3083.0,6131226.150251811,33625200,851512055,34537,12746665
432,2017-01-04,50673,7864431.659219265,1769.0,4693466.5388841545,41051200,985515893,41455,12788120
433,2017-01-05,49596,8083783.69007527,2593.0,3247566.4616866247,41557400,898497892,40715,12828835
434,2017-01-06,43804,7418701.910839437,2024.0,13851408.214626582,29471800,898845928,37496,12866331
435,2017-01-07,43622,4402116.5860519195,1868.0,36704916.854372896,23153600,865194523,37324,12903655
436,2017-01-08,42727,2502407.3464800203,1729.0,19567148.44830356,16676600,902576769,35664,12939319
437,2017-01-09,46188,4414005.118137535,1414.0,15562890.489835273,25718300,906044584,38678,12977997
438,2017-01-10,48179,4590323.726714144,2845.0,11603891.640704758,10879700,926031183,37207,13015204
439,2017-01-11,45221,4615552.931750861,1180.0,7221844.002194295,26823500,853319722,38108,13053312
440,2017-01-12,50589,4551485.767866457,2240.0,17345989.64484438,30453800,866237622,39274,13092586
441,2017-01-13,50833,2495575.396425337,2584.0,42743493.00485322,25066600,858481082,38185,13130771
442,2017-01-14,42044,937738.1713135247,1286.0,6513421.793076819,20085800,847990590,35280,13166051
443,2017-01-15,41748,585164.107790207,1460.0,8036417.835212171,14837900,870948977,34580,13200631
444,2017-01-16,45375,804567.6549709819,903.0,4787137.99965272,14937400,847706513,37955,13238586
445,2017-01-17,46671,1557510.8335576877,2893.0,5964179.52046272,18391900,906597925,37711,13276297
446,2017-01-18,44994,872855.3133165116,1171.0,2.315841784746324e+59,10788200,900365728,37782,13314079
447,2017-01-19,43628,1002452.4034286728,2315.0,7485185.7455252,8347550,915611849,37055,13351134
448,2017-01-20,45775,2698653.9326703306,2548.0,13779749.218892053,10992800,933854252,38220,13389354
449,2017-01-21,43302,945926.6960306248,1405.0,11227503.25271229,11937600,961383820,36809,13426163
450,2017-01-22,47432,979877.2002894221,1761.0,12239112.7683082,8678620,943567856,37653,13463816
451,2017-01-23,46076,882413.1957239409,1374.0,40126344.18719274,7267210,954275900,37665,13501481
452,2017-01-24,50414,789250.4132579345,3759.0,36062591.05759693,8327330,938004330,38238,13539719
453,2017-01-25,46256,947379.6037170435,2594.0,23834640.146410313,6751450,932866678,36495,13576214
454,2017-01-26,46856,1069408.853070963,2890.0,29933529.19361879,8465020,934844928,36041,13612255
455,2017-01-27,46680,1025230.1941376437,2887.0,31666471.207204714,7189170,930599699,36571,13648826
456,2017-01-28,45189,600591.2972920956,1594.0,22311099.81801214,6580700,933378690,35728,13684554
457,2017-01-29,42509,871346.3730780744,1493.0,4577299.481836812,4689950,926548657,34923,13719477
458,2017-01-30,45369,696722.9657690447,937.0,8600125.417111473,8042180,934593362,36432,13755909
459,2017-01-31,43649,1278335.729361472,3123.0,10503551.6049317,11648700,948748952,35511,13791420
460,2017-02-01,44541,1269717.168074696,3402.0,11827943.62347486,12852200,949491718,35246,13826666
461,2017-02-02,43709,1230226.9227244402,2449.0,5263818.883658299,10172500,957731836,36692,13863358
462,2017-02-03,42778,1638917.6252514042,2866.0,2.315841784746324e+59,12897800,984019776,35632,13898990
463,2017-02-04,45410,1769220.9580738884,1571.0,4975214.450383442,14139500,1012625893,38411,13937401
464,2017-02-05,46542,745254.6726403264,1858.0,8101142.154708202,5942960,1005855021,38908,13976309
465,2017-02-06,47306,1374158.9288751606,1084.0,4537566.880524617,5695440,1009440330,38078,14014387
466,2017-02-07,51866,1276192.8741873363,3180.0,9701982.147517994,7629640,1020961130,38179,14052566
467,2017-02-08,51089,1194714.2235380244,2414.0,12218406.935237655,9688630,1013867331,38490,14091056
468,2017-02-09,47873,1337668.7784119644,2590.0,6860343.367671582,18400300,978825690,38753,14129809
469,2017-02-10,52222,1644273.3543715624,2477.0,3818591.539291275,11914200,1001069228,40341,14170150
470,2017-02-11,46560,933102.9234020637,1658.0,4097192.88984692,7544520,1007694076,35883,14206033
471,2017-02-12,45319,1211266.4015818818,1857.0,5702176.677302541,6264900,1012466457,36526,14242559
472,2017-02-13,55990,1209427.6914809807,1297.0,6599689.360628077,7216520,1001304093,42825,14285384
473,2017-02-14,58298,3490263.2285443777,3205.0,10942157.912419073,42911500,1157709435,43977,14329361
474,2017-02-15,55320,4196306.616144697,2273.0,14521776.352149753,18464700,1148742628,43918,14373279
475,2017-02-16,49674,2388301.688610187,1173.0,6965795.782274078,38002600,1147726668,41744,14415023
476,2017-02-17,49406,2586272.82635722,931.0,2646749.7843334726,11636500,1127915204,40427,14455450
477,2017-02-18,49398,2382502.949404007,3119.0,304365824.86116827,9370010,1140211197,39994,14495444
478,2017-02-19,48227,2344861.154339072,1100.0,51215806.883409,7799740,1136008890,38927,14534371
479,2017-02-20,50152,2452295.5173922144,1317.0,7483239.1678039655,12994400,1107158285,40458,14574829
480,2017-02-21,58434,3791885.3812102196,12748.0,32953717.800417982,15183300,1128781640,40132,14614961
481,2017-02-22,50372,2695505.3190605515,4522.0,12467954.27179681,10360900,1123050433,39252,14654213
482,2017-02-23,47601,2600130.401885899,2715.0,27415343.730378285,14522300,1169783161,39004,14693217
483,2017-02-24,54081,5121363.576134729,3034.0,14426311.756605571,19574400,1165715765,43425,14736642
484,2017-02-25,53245,3189879.2014478706,3781.0,2.315841784746324e+59,18533900,1208911983,41612,14778254
485,2017-02-26,51716,3848279.91004955,2067.0,4.631683569492648e+59,20307500,1296040794,41513,14819767
486,2017-02-27,52642,9134717.133860799,1999.0,7813653.176882541,31667000,1374757041,43711,14863478
487,2017-02-28,60277,11313887.546580996,3938.0,5923153.618394137,65478900,1412825288,49551,14913029
488,2017-03-01,59774,11794331.082539598,2391.0,38442404.50422743,44927500,1550251865,48934,14961963
489,2017-03-02,70779,17326741.74118258,3588.0,10329917.270348502,83627104,1701011948,59577,15021540
490,2017-03-03,64294,16477216.37998447,3521.0,8965075.00677173,95863400,1739949803,54504,15076044
491,2017-03-04,58756,10685158.206459327,1851.0,16979095.17718291,27341900,1665411583,49351,15125395
492,2017-03-05,57031,9159895.856143301,1804.0,14927348.62499289,26816300,1727148626,48137,15173532
493,2017-03-06,57020,15317117.383132724,1318.0,230875335.4829695,32432700,1754907794,50220,15223752
494,2017-03-07,62589,10370427.783241555,3020.0,29135241.004105814,37972200,1691307055,49099,15272851
495,2017-03-08,55386,11254305.285379332,2130.0,20085114.732993264,44304600,1491498830,48448,15321299
496,2017-03-09,64266,14873759.30103362,3696.0,28491270.679334756,31418400,1590879625,51793,15373092
497,2017-03-10,65132,13513630.553081995,3184.0,12535406.052674497,87506800,1732837145,53028,15426120
498,2017-03-11,64803,15916469.537508806,2523.0,9.263367138985296e+59,69150096,1925342939,54782,15480902
499,2017-03-12,66646,24131714.476349223,2352.0,1.157920892373162e+59,74628896,2102276260,56363,15537265
500,2017-03-13,81718,18840450.367489785,2398.0,205534599795.9082,255488000,2565583285,71860,15609125
501,2017-03-14,77155,7878392.307183885,3735.0,88022804436.88536,101797000,2572014998,63398,15672523
502,2017-03-15,81205,7858661.153497543,3695.0,20035218805.62895,170344000,3147689118,67230,15739753
503,2017-03-16,109950,31594465.073712714,4928.0,45999069.60753537,454417984,4162873752,92212,15831965
504,2017-03-17,106635,16092010.448921014,4400.0,58094621.18446245,497534016,4207676009,91721,15923686
505,2017-03-18,89920,23550400.745553765,4371.0,8664617.019597612,262180000,3070500515,77021,16000707
506,2017-03-19,84599,5215428.561047437,2748.0,299800011917553.5,239430000,4022867100,69605,16070312
507,2017-03-20,80264,6596451.991923457,2448.0,1000028580153.0656,154700992,3902862599,69058,16139370
508,2017-03-21,84298,13135570.343903478,4964.0,38682623.18684708,91265400,3882154700,68865,16208235
509,2017-03-22,78821,11430388.31173067,3228.0,35033881.108553424,113952000,3811229796,65023,16273258
510,2017-03-23,82434,11598843.91717071,4382.0,10517246.574166866,100724000,3932863932,65797,16339055
511,2017-03-24,87775,15951214.862826746,4352.0,11055392.060890201,297046016,4783511280,74950,16414005
512,2017-03-25,84394,12107131.9692639,3609.0,6434894.068274748,223059008,4617794703,71911,16485916
513,2017-03-26,79534,9610468.06424788,3169.0,18394844.29192898,106859000,4553738462,64850,16550766
514,2017-03-27,94570,11032150.18047017,4078.0,20027022.89949183,118978000,4478238274,70211,16620977
515,2017-03-28,84348,11011213.61699702,4938.0,23459991.963204347,97745296,4579693493,67106,16688083
516,2017-03-29,93064,13275251.960381605,12374.0,30621490.131208163,144998000,4793424049,69781,16757864
517,2017-03-30,96209,17262082.81585449,9427.0,73262421.01012965,86885696,4711996588,77681,16835545
518,2017-03-31,103102,14676388.252222724,6187.0,34360603.16967826,151416000,4517835716,86351,16921896
519,2017-04-01,80572,9648521.561106969,3872.0,33622636.31552212,92461904,4579187936,65181,16987077
520,2017-04-02,88948,15178511.54425901,3432.0,9654051.760677118,134604000,4404475423,74419,17061496
521,2017-04-03,100221,17019449.45869939,3004.0,3.473762677119486e+59,190512992,4009009196,87587,17149083
522,2017-04-04,86279,8437024.107249882,4705.0,8847028.502515066,157568000,4036201194,71026,17220109
523,2017-04-05,87411,12184345.74754995,3873.0,12158412.63055072,119733000,4097477788,71329,17291438
524,2017-04-06,95177,17299345.842499994,5276.0,112984131.34717806,147120000,3912317959,80148,17371586
525,2017-04-07,92846,5141378.062865886,4728.0,13677489.778682442,81474704,3815963046,66930,17438516
526,2017-04-08,72144,6764809.236537598,4078.0,8024566.869537006,74138800,4011422381,59975,17498491
527,2017-04-09,74557,6787137.231504675,3422.0,15541496.949565385,55143000,3918563431,58802,17557293
528,2017-04-10,75487,8607997.775931126,2758.0,18860341.13891628,44061500,3935103268,62891,17620184
529,2017-04-11,75891,8539843.36409453,4894.0,5170806.081736152,38303300,3933886291,61282,17681466
530,2017-04-12,80347,7952523.152422924,3334.0,406596281.29631835,88045696,4196302994,63424,17744890
531,2017-04-13,84124,5874226.303570253,8455.0,7555621.315868908,157200000,4554299452,67203,17812093
532,2017-04-14,81155,7148601.635517666,4674.0,5130272.495073825,91674400,4315878957,65019,17877112
533,2017-04-15,74820,3558856.495737571,3921.0,5647830.15097855,66207800,4455916490,61845,17938957
534,2017-04-16,70634,1799204.2388226432,3501.0,4920223.014454555,31343800,4422644315,56240,17995197
535,2017-04-17,72546,2397753.8257525237,3088.0,12661901.550772348,44013300,4386552041,58531,18053728
536,2017-04-18,83303,8528651.430449804,8053.0,56071079.569748245,78748496,4606307174,65417,18119145
537,2017-04-19,85734,9690562.087530961,10964.0,32262158.362476356,76281000,4389519738,67287,18186432
538,2017-04-20,85450,11012848.351665141,6185.0,27377317.034289148,79600896,4515241563,70027,18256459
539,2017-04-21,81278,7754905.869488127,6771.0,21517124962.206528,45048300,4385105012,61046,18317505
540,2017-04-22,73539,6948387.926679504,4913.0,10112047.707462542,37357600,4416442028,59471,18376976
541,2017-04-23,77073,7001175.68411273,4450.0,24593193.59318228,36234000,4412126295,61989,18438965
542,2017-04-24,80531,8566631.51018044,4876.0,35151233.429309286,55580600,4553943109,66810,18505775
543,2017-04-25,93033,7859324.592553792,8001.0,41622331.34785229,38264600,4542708761,65843,18571618
544,2017-04-26,89642,11169801.635887174,6886.0,20137971.366790548,104884000,4801851008,73139,18644757
545,2017-04-27,104494,15263875.938175913,14796.0,109998222.07369325,246775008,5664157655,81404,18726161
546,2017-04-28,106193,14523963.738976326,18208.0,82306179.17422764,346545984,6394355247,78945,18805106
547,2017-04-29,91335,14030864.558104968,8731.0,103341602.8710042,165448000,6233911088,73423,18878529
548,2017-04-30,95202,16134880.72917455,11063.0,61319726.385382414,229944992,7206669917,76256,18954785
549,2017-05-01,112202,24428041.839859713,19941.0,39913107.8505873,376841984,6960466482,84478,19039263
550,2017-05-02,110354,20283461.80418618,16900.0,40475338.8827928,193772992,7050941746,84175,19123438
551,2017-05-03,97334,22560338.616467945,13991.0,27307911.35954218,141922000,7277279246,76968,19200406
552,2017-05-04,114877,22925157.21629886,13837.0,2087845343.3250215,366847008,8856050446,94967,19295373
553,2017-05-05,108514,23285297.121958565,9470.0,1081841792.0005887,331928000,8622992171,92305,19387678
554,2017-05-06,95014,15506350.566846438,10865.0,16462788.367773674,151462000,8937843151,80138,19467816
555,2017-05-07,106631,19881783.439688243,8518.0,19572485.885422103,183295008,8592854298,88368,19556184
556,2017-05-08,117509,19478435.222374734,10564.0,25622322.814528063,231344000,8359085414,100150,19656334
557,2017-05-09,112933,19519746.047667887,10400.0,17368918.41079555,363433984,8338258352,94129,19750463
558,2017-05-10,109673,18657454.96997965,9914.0,27386525.455292296,145602000,8191083680,90315,19840778
559,2017-05-11,117189,22844736.006155863,10492.0,16447861.621536648,132722000,8226220249,96040,19936818
560,2017-05-12,107241,18124928.74481112,8876.0,20062976.151304383,145824992,8116816184,88921,20025739
561,2017-05-13,101332,13411444.320814256,11962.0,200469493.690432,88742200,8319066651,79885,20105624
562,2017-05-14,101348,12542412.728441546,6972.0,51871381.445337206,66046600,8317148601,82976,20188600
563,2017-05-15,122792,16972201.929702893,11481.0,35533913.71056739,170999008,8468960166,96232,20284832
564,2017-05-16,116341,21748819.25275555,7995.0,32137258.062925037,152284992,8198722531,95831,20380663
565,2017-05-17,140135,14251503.083912687,15725.0,94538958.08170548,183031008,8239948169,112202,20492865
566,2017-05-18,137409,9465795.777673585,12781.0,42071330.61078788,196236992,8888797357,108070,20600935
567,2017-05-19,161568,15070150.90189911,11796.0,23117266.322151285,626945024,11884632930,133821,20734756
568,2017-05-20,130912,9672987.49648885,11620.0,26144207.206618875,331455008,11612447946,100413,20835169
569,2017-05-21,149699,12861985.06705222,12355.0,43588262.16732168,570361024,14500421529,113477,20948646
570,2017-05-22,176255,26261823.744735025,10083.0,19892579.673254594,1188909952,16004156112,140980,21089626
571,2017-05-23,187121,16168163.832595218,14559.0,98625582.92544349,530708992,16715702521,147865,21237491
572,2017-05-24,187293,15619943.690182475,16290.0,38886284.4204607,561014016,17464735543,145698,21383189
573,2017-05-25,183010,14607288.004161803,13205.0,20005001.78999593,943636992,16036165877,147177,21530366
574,2017-05-26,169818,16485062.432216825,10410.0,120122042.75752684,792457984,14749889600,137717,21668083
575,2017-05-27,149450,12055646.18109762,8990.0,24571199.018709794,1217059968,14511207045,119417,21787500
576,2017-05-28,155271,9898699.166603642,11570.0,45862863.60532258,717971008,15689192548,116681,21904181
577,2017-05-29,158547,10434462.551227154,10393.0,984289137.9033595,718828032,17939882189,126360,22030541
578,2017-05-30,193618,11983948.652157333,12976.0,26121574.101132475,1586669952,21352550184,150537,22181078
579,2017-05-31,214126,23035150.193629213,11826.0,366352964.3060229,1271600000,21244817139,183071,22364149
580,2017-06-01,199160,16578430.165260587,13297.0,156683329.25212747,812924032,20474652879,163947,22528096
581,2017-06-02,194911,16305245.466923295,23910.0,75546586.3206905,469532000,20622162299,139466,22667562
582,2017-06-03,175666,15448292.435237003,14361.0,129732778.96479405,427896000,20683715605,137806,22805368
583,2017-06-04,180136,13806026.17238471,15981.0,221976267.38550124,753820032,22622207553,138157,22943525
584,2017-06-05,190305,17087868.584131427,16571.0,105120190.72579943,435660000,22917910489,153432,23096957
585,2017-06-06,200523,20321577.127376616,16537.0,101255536.35412748,741553024,24401181121,160898,23257855
586,2017-06-07,207180,17926095.0709268,23182.0,98258273.92561781,461648992,23818300202,157066,23414921
587,2017-06-08,187700,15514342.200651089,18013.0,699097997.557544,385494016,24157329921,145354,23560275
588,2017-06-09,215831,16042141.28768361,28760.0,272604758.2408175,557985984,26018098658,166192,23726467
589,2017-06-10,213356,11222492.903393537,17532.0,73772199.60901868,1611629952,31192780483,173875,23900342
590,2017-06-11,240490,12178644.7776374,15854.0,67938549.58012716,1373219968,31473965821,196940,24097282
591,2017-06-12,292941,26183940.227759853,46240.0,176898356.53441578,2882650112,37110948644,249377,24346659
592,2017-06-13,280054,21405672.791022763,22031.0,59905110.48569399,1717379968,36756801123,228999,24575658
593,2017-06-14,250410,13320247.215948585,20204.0,47947738.81654585,1272579968,33208658542,208193,24783851
594,2017-06-15,261617,20762248.221933056,23946.0,260631896.5290881,2463450112,33485258152,221490,25005341
595,2017-06-16,248003,18262183.869493462,24779.0,1372387181.1770246,1096280064,34263095462,198207,25203548
596,2017-06-17,242022,10259156.638504008,24715.0,99272087.58943672,904652992,35124053707,191701,25395249
597,2017-06-18,245957,9480966.511448368,17628.0,56327293.815228716,904702976,34398150201,201207,25596456
598,2017-06-19,286209,11094338.703240497,35668.0,320297641.16284466,685171968,34278915230,221191,25817647
599,2017-06-20,308488,14494001.2251311,35766.0,2399230865.7626915,1020390016,33260958885,267968,26085615
600,2017-06-21,221289,5774091.405088148,28055.0,5143500763.227832,1420130048,31222823000,204974,26290589
601,2017-06-22,284225,8437572.360542275,24811.0,156083847.66540235,925766976,31185326164,235751,26526340
602,2017-06-23,276012,10163212.235555246,29855.0,609794740.1566892,593206976,31691908924,226767,26753107
603,2017-06-24,250570,11330287.27652525,20951.0,134588551.2794271,673585024,30027238696,206959,26960066
604,2017-06-25,231135,4063036.703999752,23476.0,604682220.9159588,1186880000,28138409364,179293,27139359
605,2017-06-26,316788,10590492.142835995,22364.0,686783834.6137416,2081810048,25309759968,273187,27412546
606,2017-06-27,252995,11675098.99900441,26258.0,877766054.312437,1973869952,27211279055,201891,27614437
607,2017-06-28,274241,10550295.906437462,37231.0,2764053271.7593274,2056550016,30454577323,199965,27814402
608,2017-06-29,263791,11167443.483638443,42618.0,2047312023.6182544,1508579968,28136918558,196691,28011093
609,2017-06-30,252652,9962127.832879985,26919.0,1.5000059999999995e+25,1011800000,27404731861,195809,28206902
610,2017-07-01,240465,9037705.813323839,29525.0,6.000020000000001e+24,1089200000,25524313603,184878,28391780
611,2017-07-02,248617,7079534.309092646,39904.0,1584576997.0483851,1123330048,26776243984,180347,28572127
612,2017-07-03,302032,24687182.33543818,51376.0,2.8066624430920223e+25,851408000,26310761677,213309,28785436
613,2017-07-04,281465,20147278.80214962,40169.0,588826090.9658083,687691008,25425860777,198979,28984415
614,2017-07-05,271606,7048728.290652036,48166.0,1.4032610584938894e+21,790256000,25011710285,195288,29179703
615,2017-07-06,258791,8334645.656588829,51458.0,3016816413.318396,623080000,25179348911,196691,29376394
616,2017-07-07,295389,9118041.030445253,62015.0,8620342483.55907,687251968,22900134646,226482,29602876
617,2017-07-08,248142,7495998.142826611,46256.0,1298923951.8042042,754958016,23443013086,178690,29781566
618,2017-07-09,225189,3432735.515220861,42929.0,10001215615581.963,505118016,22559120946,163895,29945461
619,2017-07-10,302633,10678315.171814691,53169.0,4329483420.063548,937219008,20069373698,220744,30166205
620,2017-07-11,291677,12854896.551574813,49702.0,1562812014.4212215,1440950016,18401040701,216751,30382956
621,2017-07-12,283828,12854120.74069273,52570.0,58997313770.0621,1241190016,21517152174,204287,30587243
622,2017-07-13,260745,21681857.457349274,40446.0,14530028762.768066,828489024,19560300930,180191,30767434
623,2017-07-14,249381,25095112.99426372,36438.0,4968155593.238376,749382016,18625794688,182905,30950339
624,2017-07-15,231961,24533259.08452871,38549.0,2405101256.7507706,810451968,15923953593,178554,31128893
625,2017-07-16,249138,25571136.69875461,42519.0,7381458604.794292,1516889984,14687441605,183874,31312767
626,2017-07-17,248473,22930804.628468513,40616.0,3377280663.7928047,1669500032,18057735704,180899,31493666
627,2017-07-18,271055,26525318.766320385,35340.0,7243948884.636982,2709260032,21887962776,195290,31688956
628,2017-07-19,270122,23338613.171259392,45761.0,14588064487.308681,2328790016,18653610729,195608,31884564
629,2017-07-20,250065,20591514.599152267,37663.0,1313834197.4809198,2224999936,21233651866,189355,32073919
630,2017-07-21,232560,21009752.300060023,35458.0,641083474.7027545,1006129984,20401709506,176346,32250265
631,2017-07-22,205574,4573361.401859657,38353.0,1317614156.5187132,618259968,21451273566,151037,32401302
632,2017-07-23,260490,6947847.764968688,45140.0,102220810130.00815,649614976,21127295409,196408,32597710
633,2017-07-24,263095,20894628.257450204,49608.0,1269029766.8474379,431691008,21016755177,181231,32778941
634,2017-07-25,242956,23158879.956086125,44398.0,2687736171.050133,1095760000,19338262506,178657,32957598
635,2017-07-26,223010,18948245.509649757,36518.0,1e+28,717692032,19085332800,165511,33123109
636,2017-07-27,225435,21070435.385767438,36223.0,3014437810.3843126,393283008,19124468250,174827,33297936
637,2017-07-28,246494,24443649.240567237,45392.0,973237429.3366216,562571008,18081289103,183990,33481926
638,2017-07-29,198773,22144629.792728074,26292.0,337923574.39108527,824355008,19272280500,158665,33640591
639,2017-07-30,206624,14212265.399820646,29941.0,665033492.2653916,596233984,18545669554,166868,33807459
640,2017-07-31,250090,8746132.82794812,43945.0,1311348361.5757117,569414016,19102596755,192957,34000416
641,2017-08-01,218582,9542662.411147984,30263.0,1814183505.8661046,1585330048,21252988047,172859,34173275
642,2017-08-02,231068,8957933.865862885,38193.0,914859356.8585651,632606016,20618746852,177213,34350488
643,2017-08-03,236335,7571817.365817945,39499.0,924656865.7854252,557217024,21128736918,173090,34523578
644,2017-08-04,257160,7794795.7248513885,40321.0,21456892550.77039,539782976,20920682038,183296,34706874
645,2017-08-05,261400,9115096.144724416,51899.0,32954210483.829384,1332999936,24061766194,184985,34891859
646,2017-08-06,265127,8663043.44310666,62030.0,2011694483920.667,1482979968,24541904159,181492,35073351
647,2017-08-07,281172,9785097.234705752,50530.0,2219183153.025473,935726976,25262099071,199484,35272835
648,2017-08-08,318866,10950203.755281357,54582.0,21513940710.599,1502409984,27857712299,225769,35498604
649,2017-08-09,280308,11108092.26980826,42647.0,2624133587.9128323,2638579968,27794475648,210196,35708800
650,2017-08-10,338241,23186339.796763793,67595.0,1198166357.399928,1076819968,27788165832,237933,35946733
651,2017-08-11,356682,46495729.37575194,79205.0,1.157920892373162e+59,953576000,29013166489,236963,36183696
652,2017-08-12,338654,27701104.122139618,78977.0,637494378.5193483,1111650048,29183139234,215251,36398947
653,2017-08-13,333011,30387440.115338333,65681.0,3.5792089237316197e+58,1369369984,28011760531,219763,36618710
654,2017-08-14,410061,24186852.25181809,81854.0,1162664153.6137474,864390976,28209451117,271480,36890190
655,2017-08-15,413246,19335475.727186687,98989.0,2.315841784746324e+59,1051800000,27249639651,283656,37173846
656,2017-08-16,413624,15415871.503296101,90673.0,1473696033.7537558,967643008,28426961863,280038,37453884
657,2017-08-17,428007,15152875.3525595,82545.0,7364411793.060512,909494016,28357573570,280045,37733929
658,2017-08-18,443356,15652250.24024123,74717.0,1.6210892493224274e+60,936160000,27812276026,309127,38043056
659,2017-08-19,377418,11754332.40845495,72898.0,4089678567.532251,860201984,27995885731,234776,38277832
660,2017-08-20,309926,10087598.377920687,59035.0,1926969633.7918282,571947008,28375046491,200284,38478116
661,2017-08-21,392880,12417529.398399398,79667.0,751425804.5688126,2448969984,30280406340,268974,38747090
662,2017-08-22,364727,11351897.121284528,85811.0,11116376959.770302,1336400000,29646659314,231485,38978575
663,2017-08-23,374711,13029522.28782471,65015.0,2.315841784746324e+59,811990016,29911326162,264616,39243191
664,2017-08-24,352465,11857251.89132324,78577.0,4.631683569492648e+59,697665024,30680964300,238123,39481314
665,2017-08-25,352621,10339449.676639507,76968.0,6.947525354238972e+59,760329024,31281210162,242554,39723868
666,2017-08-26,306268,5354422.985044571,69869.0,1240169295.5339992,514180992,31472781162,195094,39918962
667,2017-08-27,324173,19567091.623883765,74255.0,112207745043.80484,633369984,32799991739,206080,40125042
668,2017-08-28,363799,28086092.937731944,77158.0,1.157920892373162e+59,854318976,32792635350,236498,40361540
669,2017-08-29,394649,20986373.630310323,93013.0,361333766483.37695,1220029952,34961063278,262161,40623701
670,2017-08-30,400220,35634014.45936471,95754.0,3.473762677119486e+59,1333319936,35705639885,257353,40881054
671,2017-08-31,384421,16527179.713558266,72969.0,94014133900.87935,706254016,36142706814,276607,41157661
672,2017-09-01,390997,15501632.904307034,83503.0,464164184439.5418,874222016,36593410761,253963,41411624
673,2017-09-02,331797,13678678.29356012,75388.0,9860817942.406446,1483600000,32942250738,221713,41633337
674,2017-09-03,302525,10556146.965468604,70660.0,2197923121.1697755,986265984,32807142041,198980,41832317
675,2017-09-04,442592,16194431.340878993,101323.0,1840740393.9305372,1801689984,27873682151,296241,42128558
676,2017-09-05,444572,15757897.759294977,115024.0,2767450180.1631727,1551049984,29562162666,292988,42421546
677,2017-09-06,496376,16142467.86384847,141080.0,9621658319.878132,1058830016,31584914370,310791,42732337
678,2017-09-07,448347,11418115.008135295,128266.0,2710068121.742215,718624000,31127463390,268572,43000909
679,2017-09-08,463670,13177442.334770313,142216.0,12956129061.160986,1098780032,28021550341,275541,43276450
680,2017-09-09,383654,19654915.58936869,112047.0,11272755915.045376,528620992,27829435118,226797,43503247
681,2017-09-10,325128,16956756.260253306,84632.0,3038631367.5542583,698326016,27300089799,205846,43709093
682,2017-09-11,365384,14885090.79340895,88770.0,1150520984.360389,571307008,27852586150,235748,43944841
683,2017-09-12,404898,15080318.361496866,106231.0,6.947525354238972e+59,753144000,27568017613,276516,44221357
684,2017-09-13,365679,9644183.784046836,108092.0,2.315841784746324e+59,921692032,26215830135,239185,44460542
685,2017-09-14,380251,14844694.903506635,116663.0,2.315841784746324e+59,1184589952,20240633669,267826,44728368
686,2017-09-15,441767,17641857.957146842,128683.0,1.85267342779706e+60,1935699968,23704566170,314630,45042998
687,2017-09-16,373764,9938636.076914562,110909.0,1.042128803135846e+60,711737024,23336257868,261353,45304351
688,2017-09-17,289517,11846347.574652718,142282.0,9.105446246612134e+59,427452000,23835888183,193054,45497405
689,2017-09-18,362764,18355286.05778205,143455.0,2.315841784746324e+59,1127750016,27794233413,223107,45720512
690,2017-09-19,337752,14709160.452263309,135152.0,20958799101.556034,646908992,26787085258,225422,45945934
691,2017-09-20,324984,9552537.721543247,98012.0,1.4607530781579207e+30,421404000,26881372918,214277,46160211
692,2017-09-21,317074,9226334.511679186,129471.0,3355532450.8181024,601265984,24502550354,202089,46362300
693,2017-09-22,271470,8368319.306238201,112708.0,4247934359.1460395,430080992,25049676632,173397,46535697
694,2017-09-23,260107,7441150.239305098,93865.0,7089846488.700643,450934016,27125537826,169183,46704880
695,2017-09-24,280929,6529797.546469122,66175.0,5099366558.725598,571411008,26780610986,166482,46871362
696,2017-09-25,306614,8270814.628313984,88414.0,26052401230.27304,483160992,27718684465,189119,47060481
697,2017-09-26,306075,8520002.090641383,100763.0,9805716829423.043,345800992,27259015800,179732,47240213
698,2017-09-27,309047,9019393.401920531,98950.0,53206357819.73913,550243968,29068342956,187467,47427680
699,2017-09-28,329208,9598453.536198772,98638.0,179883383440.3857,501894016,28379292201,198779,47626459
700,2017-09-29,326502,8168469.8477132,75946.0,1.0000052599276306e+16,541374976,27654290280,212004,47838463
701,2017-09-30,295798,6388802.636517368,69315.0,21935341105.604435,332439008,28607406298,179369,48017832
702,2017-10-01,283871,4480022.162099804,70379.0,1015643040006.3088,306184992,28694730559,169978,48187810
703,2017-10-02,306095,7025873.46226021,73303.0,9.962526758071532e+29,339443008,28237763674,191011,48378821
704,2017-10-03,327906,22472997.673759732,76611.0,17622874239.676838,321680000,27766443809,202417,48581238
705,2017-10-04,307399,14933701.51506365,62404.0,11233083574.865627,257906000,27789444567,187606,48768844
706,2017-10-05,314808,9382903.96323688,63488.0,9347045776.69934,253747008,28098336333,191752,48960596
707,2017-10-06,319882,9387262.093987282,66868.0,1.157920892373162e+59,318664000,29311483315,189722,49150318
708,2017-10-07,291091,7475564.374483842,73016.0,10185936088.011791,342204992,29557048403,180342,49330660
709,2017-10-08,296829,8480530.912163198,78220.0,1.0500000000000062e+25,293167008,29322710612,183169,49513829
710,2017-10-09,328172,10293396.820268847,78970.0,32784902359.83248,559467008,28261533648,210750,49724579
711,2017-10-10,349605,11043438.899310263,95132.0,6849155692.948928,359705984,28501667385,226769,49951348
712,2017-10-11,344305,9815735.848813431,77897.0,52684185637.30375,264146000,28847211568,223683,50175031
713,2017-10-12,363411,10874553.093790732,93665.0,125992200919.79623,527556992,28916525240,222864,50397895
714,2017-10-13,379136,13885881.677523844,95877.0,3.0000027927331066e+17,1304359936,32213441854,249531,50647426
715,2017-10-14,332169,10015106.522822773,89823.0,133116675768.57997,516561984,32301459659,212237,50859663
716,2017-10-15,328921,9199288.361520754,80695.0,9018742099.304285,635406976,32018244067,205403,51065066
717,2017-10-16,408297,7409743.212998443,145638.0,7547083839.29739,692884992,31718200756,202330,51267396
718,2017-10-17,505611,11095662.962082004,161713.0,8.000000000000001e+58,509924000,30173609812,255141,51522537
719,2017-10-18,470449,14603488.436306419,123942.0,14270338648.156353,606113984,29917084625,236552,51759089
720,2017-10-19,494184,12368585.965552596,128923.0,18346825676.20626,349830016,29330304837,224151,51983240
721,2017-10-20,546837,11369852.209634516,136854.0,1.0010000000000009e+27,396672992,28947916800,232782,52216022
722,2017-10-21,462902,10437676.942778049,91181.0,6854386383.906218,408014016,28590314194,226834,52442856
723,2017-10-22,435493,9259524.814162727,66745.0,25347162007.143116,327387008,28144794782,247679,52690535
724,2017-10-23,468168,12801962.88552925,154845.0,57411229829.97799,482336000,27341319876,246918,52937453
725,2017-10-24,492288,12545369.553001571,144217.0,200062353467.7094,684281024,28431576038,247451,53184904
726,2017-10-25,460419,10172837.498044644,156662.0,75638295846068.95,325040000,28399185652,222923,53407827
727,2017-10-26,466406,9734536.262847573,187331.0,1e+59,270272992,28271925666,228610,53636437
728,2017-10-27,486147,10304797.666791152,214388.0,2.0001447188417e+16,257168992,28363439564,217344,53853781
729,2017-10-28,484554,12585068.010343254,243867.0,1.157920892373162e+59,264424000,28262202960,211032,54064813
730,2017-10-29,494176,11488201.349777818,253733.0,196628910809.91946,551752000,29106827254,213486,54278299
731,2017-10-30,532626,10826790.209116045,256520.0,15973509258599.352,331441984,29367079933,232783,54511082
732,2017-10-31,519906,11479945.362770827,240478.0,2640022879032.1904,369583008,29194751985,251159,54762241
733,2017-11-01,527783,13997069.165267771,223770.0,237436647609.43442,553864000,27846764494,266577,55028818
734,2017-11-02,529277,15710633.325772742,253213.0,45843903843.18334,904900992,27445442368,284767,55313585
735,2017-11-03,485790,12435609.143415544,294810.0,69543600595.63327,646339968,29197317355,243127,55556712
736,2017-11-04,398758,8449990.77513536,235019.0,115333751647.19337,416479008,28702737365,198011,55754723
737,2017-11-05,417102,7940924.9617356025,153915.0,109403918898.49324,337657984,28307052341,188789,55943512
738,2017-11-06,511663,9644983.37757122,148564.0,807772118010.6074,579358976,28564296472,224281,56167793
739,2017-11-07,470418,7980281.166593398,155067.0,4252482643871.449,540766016,28165778801,230898,56398691
740,2017-11-08,480413,11326171.44609981,139543.0,2.00000000000004e+24,967955968,29549552409,254730,56653421
741,2017-11-09,467172,18444337.33931168,111899.0,176597379343.30362,893249984,30685584327,255661,56909082
742,2017-11-10,457427,13536895.350065121,128958.0,20907266162266.926,885985984,28623188738,256826,57165908
743,2017-11-11,394378,12535053.778247278,218486.0,9675818254.609385,842300992,30105285828,217210,57383118
744,2017-11-12,434380,17213856.95143672,206214.0,4017664146877.2793,1613479936,29463540579,269194,57652312
745,2017-11-13,443176,11224399.94986657,205795.0,2.315841784746324e+59,1041889984,30312834756,254677,57906989
746,2017-11-14,475984,10928738.011707056,188912.0,1.736881338559743e+59,1069680000,32321383639,268901,58175890
747,2017-11-15,540593,16658154.948981958,142551.0,27347168466.197422,722665984,31919060540,320874,58496764
748,2017-11-16,491482,15322165.555335572,148218.0,9023178468522.258,797254016,31692795453,272981,58769745
749,2017-11-17,508590,15489226.019431554,143774.0,22675356943.03094,621732992,31840349187,301118,59070863
750,2017-11-18,459679,12789056.204160545,231345.0,3.473762677119486e+59,649638976,33305160559,254501,59325364
751,2017-11-19,464563,12683320.96958482,206864.0,20705190363.746788,1181529984,33961430090,264686,59590050
752,2017-11-20,530141,16812431.208967537,193581.0,1.157920893373162e+59,807027008,35151847933,280093,59870143
753,2017-11-21,524044,16396325.149233477,186154.0,9.999999999999999e+49,949912000,34552559750,311093,60181236
754,2017-11-22,546489,16665737.065049486,158197.0,5.78960446186581e+58,800819008,36501878925,319658,60500894
755,2017-11-23,537068,16149813.524754807,154515.0,30208464053.61085,1845680000,39340408036,312775,60813669
756,2017-11-24,525529,13787777.813809695,170248.0,1.15792e+33,2292829952,45560021462,315953,61129622
757,2017-11-25,561166,16145472.189215368,214950.0,1.15792089237316e+58,1422080000,44741093552,301838,61431460
758,2017-11-26,542484,15645444.183980018,152935.0,253787625053.59906,1197779968,45235644662,297452,61728912
759,2017-11-27,608695,19751087.703352902,1075220.0,1063154525504.0671,1396480000,46111561438,365682,62094594
760,2017-11-28,638989,24235402.604366988,240725.0,89918110174853.03,1346499968,45405717909,392909,62487503
761,2017-11-29,663579,27582760.471128702,189934.0,1.157920892373162e+59,2675940096,41057383009,431202,62918705
762,2017-11-30,655457,25796604.380472805,157083.0,2.315841784746324e+59,1903040000,42947937239,413392,63332097
763,2017-12-01,622720,21299647.98525807,164500.0,3333399759437120.5,1247879936,44823457369,375409,63707506
764,2017-12-02,627785,22501830.650896166,191224.0,1.0000000000002975e+25,943649984,44535863933,382347,64089853
765,2017-12-03,693808,21200826.56285355,186659.0,3.4737626771194825e+59,990556992,44776362724,434020,64523873
766,2017-12-04,701834,20596582.507429272,163792.0,1.157920892373162e+59,1005550016,45204145125,481628,65005501
767,2017-12-05,693090,9843414.739356773,163142.0,6501147406.3623,1216720000,44548159326,475953,65481454
768,2017-12-06,791746,14234966.48609474,130587.0,7550984970.640151,1998259968,41220997942,617978,66099432
769,2017-12-07,659068,10892106.029461054,135413.0,19751559232.56684,2129570048,41789848007,445383,66544815
770,2017-12-08,766411,9026760.768067,191975.0,6.283185307179586e+35,2336379904,43879256076,527018,67071833
771,2017-12-09,707223,6596692.271722813,215403.0,7382783867717305.0,2003849984,45570080683,475623,67547456
772,2017-12-10,716575,6377002.939659069,210948.0,30965805536.805153,1404179968,42520479602,475384,68022840
773,2017-12-11,828899,6560127.723570464,209324.0,1028922266575.41,1771440000,49597927198,568640,68591480
774,2017-12-12,872340,13001845.810864352,223965.0,1.000000046464205e+18,5179829760,62733982232,591663,69183143
775,2017-12-13,909631,10665605.508896774,213659.0,1.0000030942869334e+16,4524539904,67692231422,629893,69813036
776,2017-12-14,942559,12198826.679871323,208022.0,3.449140143541738e+29,3821580032,67036917107,679180,70492216
777,2017-12-15,904346,10107583.27081901,179451.0,1.157920892373162e+59,2758710016,65956174321,634598,71126814
778,2017-12-16,899857,8304634.033489326,216767.0,1.0000063765948384e+16,2165690112,67103695920,606438,71733252
779,2017-12-17,876574,8071678.663630519,210522.0,1039722811027.5175,2147389952,69409025338,573653,72306905
780,2017-12-18,984021,8681279.261000767,225996.0,1.157920892373162e+59,3249230080,76623897492,676607,72983512
781,2017-12-19,1092234,11277702.089277789,231809.0,200038370144422.66,4096549888,79743740362,775474,73758986
782,2017-12-20,986104,13035720.627100658,187609.0,179582108163702.03,3969939968,79014430828,757335,74516321
783,2017-12-21,1072665,13251113.11923602,251892.0,7614177510352128.0,3569060096,79221896341,810999,75327320
784,2017-12-22,1103523,14386497.484663585,237748.0,1.0001469900315396e+20,4977710080,65129109277,835686,76163006
785,2017-12-23,918881,9519429.832911935,267797.0,3.473762677119486e+59,2480339968,69441297649,631630,76794636
786,2017-12-24,758234,7433325.332243077,172013.0,2.315841784746324e+59,2300549888,67019237420,501010,77295646
787,2017-12-25,752361,6267329.302048629,192183.0,5.78960446186581e+59,2491760128,73955757349,503432,77799078
788,2017-12-26,813510,8859600.890425935,241416.0,2.0305158916835856e+17,2201159936,74744613931,564875,78363953
789,2017-12-27,912752,10148891.419229696,292815.0,1.157920892373162e+59,2100029952,73698377070,626352,78990305
790,2017-12-28,949503,12638143.90022064,273815.0,1997617646782151.0,2389149952,71219054808,665396,79655701
791,2017-12-29,1090191,14700127.00261885,227482.0,1.157920892373162e+59,2648969984,72835328712,813920,80469621
792,2017-12-30,1136659,16330126.884015523,171403.0,2.3162469088997776e+16,3187780096,69338470696,888332,81357953
793,2017-12-31,946981,9054815.003399631,189849.0,1.9089666688936228e+16,2554269952,73170170967,674414,82032367
794,2018-01-01,908945,8253126.658589838,190637.0,5.6200000000010104e+29,2595760128,74724233458,639915,82672282
795,2018-01-02,1153936,13993600.55261567,218737.0,6.55531821687407e+16,5783349760,85552984077,857028,83529310
796,2018-01-03,1238030,13987792.334267857,197512.0,1.0000637547809149e+17,5093159936,93146829617,968350,84497660
797,2018-01-04,1349890,20246330.894750446,159499.0,1.624484667093239e+17,6502859776,94924308783,1133228,85630888
798,2018-01-05,1271577,18532512.659965534,177771.0,1.8120201358068484e+16,6683149824,96574936368,1041371,86672259
799,2018-01-06,1226417,15416741.662602155,188858.0,1.157920892373162e+59,4662219776,100852102738,970181,87642440
800,2018-01-07,1152722,12297041.270083241,208099.0,5085448518209631.0,5569880064,111670667774,862026,88504466
801,2018-01-08,1215473,15153420.055361437,205727.0,1.7949340190764324e+16,8450970112,111244629093,928872,89433338
802,2018-01-09,1256240,16127114.031130359,192657.0,1199093826636560.8,7965459968,125917925182,997286,90430624
803,2018-01-10,1177685,17375546.301690053,185668.0,1.157920892373162e+59,9214950400,121689425203,933968,91364592
804,2018-01-11,1173965,15800836.124592721,194439.0,3.545150415237435e+17,7235899904,111937424561,928808,92293400
805,2018-01-12,1118757,12519124.152347205,214798.0,1645674036919325.2,5222300160,123426938667,831398,93124798
806,2018-01-13,1179321,9574285.588748645,199020.0,3.146267594256744e+16,5746760192,135400735922,839337,93964135
807,2018-01-14,1081593,24882282.106866993,212899.0,1.157920892373162e+59,4841630208,132554906162,779591,94743726
808,2018-01-15,1206420,11724453.7798858,207088.0,3.0038330488997824e+16,4781100032,125319766537,940826,95684552
809,2018-01-16,1277936,15279817.41390008,211571.0,1.157920892373162e+59,8405139968,102231295311,1006125,96690677
810,2018-01-17,1277083,16013219.615743225,206332.0,4.3564402074647336e+16,8545160192,98429091487,1005811,97696488
811,2018-01-18,1205184,13789861.929781254,222689.0,2.2031520020006212e+16,5938319872,100588318055,921894,98618382
812,2018-01-19,1043257,9141807.335965145,216918.0,6.000000000000203e+30,4084450048,100883462786,738714,99357096
813,2018-01-20,984489,7810042.713665577,254408.0,2.096548856967795e+17,3975190016,112174461242,661417,100018513
814,2018-01-21,1006530,7459669.064583077,222396.0,2.2767764931085696e+16,3378089984,101943726022,751429,100769942
815,2018-01-22,972911,8941900.82280368,227059.0,7.90866525180512e+16,3810099968,97465684890,703508,101473450
816,2018-01-23,928494,8612842.784012487,243596.0,1.0000000000226722e+27,3556699904,95831359552,639528,102112978
817,2018-01-24,913668,8615065.42814238,260378.0,5e+43,3944039936,102902843882,608023,102721001
818,2018-01-25,788515,4104179.736514862,284316.0,1.3556896029280244e+19,4050190080,102657059605,474739,103195740
819,2018-01-26,953429,9961352.771434618,290742.0,9.678003181193334e+29,3617690112,102595008990,663866,103859606
820,2018-01-27,831992,6427148.527789768,220606.0,1.157920892373162e+59,3002870016,107663911307,559309,104418915
821,2018-01-28,889104,7324258.340187732,221434.0,6.462176320763463e+18,5372329984,121201618306,592739,105011654
822,2018-01-29,936845,7971458.155789744,196949.0,1.2392782030331003e+18,3715079936,115034583684,658035,105669689
823,2018-01-30,906578,8500894.84798845,220669.0,2.041014872007633e+18,4107859968,104234481555,611639,106281328
824,2018-01-31,877284,8223131.208813354,251292.0,1.157920892373162e+59,3757560064,108848638400,611678,106893006
825,2018-02-01,1008759,8291407.484465972,230724.0,6.111642260095283e+60,5261680128,100935354837,754031,107647037
826,2018-02-02,981133,11127821.446750734,232463.0,7.402612278675187e+59,6713290240,89173962074,705620,108352657
827,2018-02-03,814486,6234963.475335129,203420.0,1.157920892373172e+59,3243480064,93890299032,542922,108895579
828,2018-02-04,800876,5081228.7899423,249738.0,2.315841784746324e+59,2997090048,81310521832,519917,109415496
829,2018-02-05,875761,7207439.0198170645,222239.0,5.489606670424641e+59,4269530112,68005284183,599365,110014861
830,2018-02-06,888219,8911214.468542099,244261.0,1.157920892373162e+59,6518269952,77294507868,609675,110624536
831,2018-02-07,818625,7033742.185659921,219427.0,2.4448055437711514e+59,3896179968,73796288509,550963,111175499
832,2018-02-08,681344,3651696.3224612237,199197.0,2.315841784746324e+59,3708189952,79733609806,420465,111595964
833,2018-02-09,789807,5153249.722589174,227468.0,1.0255519851807438e+16,2495820032,86191922699,492426,112088390
834,2018-02-10,848390,5783733.3902549865,258178.0,8.888889709992981e+23,2930530048,83922989198,527215,112615605
835,2018-02-11,773496,3997940.632437451,280957.0,9.906122593657308e+58,2486650112,79476512347,458140,113073745
836,2018-02-12,829020,4659353.872115091,270397.0,4.249127033803992e+17,2243450112,84767037716,518035,113591780
837,2018-02-13,745822,6446480.1073983945,248727.0,1005594872398567.6,2081170048,82496189206,458392,114050172
838,2018-02-14,746384,4894972.698948495,232831.0,1.1579387678962003e+59,2818370048,90157005929,476672,114526844
839,2018-02-15,777318,5502781.147369389,263632.0,1.0979974412631517e+29,2900100096,91485862822,493581,115020425
840,2018-02-16,704758,4353434.377286602,261136.0,6.962225521817928e+59,2369449984,92211437654,428428,115448853
841,2018-02-17,772079,4192620.682056391,278206.0,8.105562038702468e+59,2525720064,95151956513,428256,115877109
842,2018-02-18,756092,4161297.1890486833,292333.0,2.315841784746324e+59,2567290112,90267805476,442396,116319505
843,2018-02-19,811384,3813863.2086926377,300776.0,1.157920892373162e+59,2169019904,92235641556,457530,116777035
844,2018-02-20,886897,4454914.411651229,361287.0,1000300887107743.9,2545260032,87514997546,490371,117267406
845,2018-02-21,850504,4355319.053512459,335071.0,2.1000000000153016e+27,2531729920,83095081059,502419,117769825
846,2018-02-22,761893,5668407.084796738,360154.0,1.471415997578492e+16,2150370048,79482140044,437837,118207662
847,2018-02-23,733084,3156491.874213884,371915.0,2.7323692829451798e+47,2334820096,84520567485,409608,118617270
848,2018-02-24,732861,2908847.159736449,396675.0,53817113391570.234,1926579968,82222377928,357653,118974923
849,2018-02-25,690582,1881537.977356103,339541.0,1e+35,1646960000,82659602549,351938,119326861
850,2018-02-26,737453,2466483.4103407054,289698.0,1676287210004.3274,2044480000,85074973200,437073,119763934
851,2018-02-27,694583,1551449.9309160626,284488.0,2.0040176661583264e+17,2053980032,85968788108,397301,120161235
852,2018-02-28,720368,1570597.4687606285,353542.0,1.157920892373162e+59,1963980032,83728564149,433272,120594507
853,2018-03-01,684404,1704977.900392486,311609.0,2.315841784746324e+59,1868519936,85410827047,394012,120988519
854,2018-03-02,744666,1559749.4608448825,365994.0,18701645002020.355,1894419968,83925690001,388664,121377183
855,2018-03-03,673465,1042462.2094517358,327855.0,5.500000000000232e+30,1699369984,83979651073,341123,121718306
856,2018-03-04,643241,1078424.9292399627,338257.0,6.78960446186581e+58,1697939968,84923240778,334198,122052504
857,2018-03-05,752756,1582393.681053965,343676.0,9.999999999999999e+47,1898489984,83667342992,412550,122465054
858,2018-03-06,712591,1957501.4600683881,296715.0,1.0000000000519998e+28,1943069952,80083929891,410730,122875784
859,2018-03-07,783757,1990546.095446438,304061.0,6.624200000001142e+24,2175419904,73813918307,512326,123388110
860,2018-03-08,690139,1678067.9869849042,340957.0,5.000000000089009e+26,1891640064,69098851661,387953,123776063
861,2018-03-09,650058,1818819.8420830683,363691.0,7525000119604577.0,2233019904,71498733754,382808,124158871
862,2018-03-10,591377,1143226.7903415414,272629.0,2.3464832698139968e+17,1532960000,67390487259,344172,124503043
863,2018-03-11,608899,1089887.689777047,311471.0,4.2e+43,1562680064,70981343639,298422,124801465
864,2018-03-12,677908,1497825.3389590771,402723.0,3905047047937390.5,1764999936,68688764839,372391,125173856
865,2018-03-13,699093,2730326.114478898,362205.0,2.000080512683581e+17,1425959936,67819092121,370567,125544423
866,2018-03-14,671198,1932198.5516443164,325608.0,15841895570136.908,1810560000,60318025226,394818,125939241
867,2018-03-15,654531,1882278.8944278602,404452.0,1523380287874396.8,1770460032,60037233577,377464,126316705
868,2018-03-16,654584,1387862.742864699,349913.0,5640178529657938.0,1417350016,59103031871,351659,126668364
869,2018-03-17,593203,1235020.196420594,334657.0,5.78960446186581e+58,1267810048,54312035489,317415,126985779
870,2018-03-18,684094,2863848.253887243,355726.0,3.473762677119486e+59,2685499904,52934184182,362993,127348772
871,2018-03-19,703891,2331654.6160811875,348987.0,1.0000186615187098e+17,2046790016,54722473140,398480,127747252
872,2018-03-20,661791,1912935.6179743896,320063.0,42991155105172.18,1833680000,54777982164,344012,128091264
873,2018-03-21,697872,1780928.6153764185,290955.0,1.157920892373162e+59,1781270016,55237391316,373927,128465191
874,2018-03-22,619453,1548703.1384111736,239038.0,2.500000000001766e+28,1523459968,53082150649,351723,128816914
875,2018-03-23,677103,2023236.105899724,272920.0,1.157920892373162e+59,1596349952,53084905906,402402,129219316
876,2018-03-24,613203,1199442.4036709652,263889.0,29848842357063.266,1300009984,51799123912,371156,129590472
877,2018-03-25,526372,991994.3284780775,250485.0,5509755371709329.0,1151170048,51598047955,289365,129879837
878,2018-03-26,626615,1953557.3721924482,270176.0,36513368893212.39,1638880000,48228842327,348241,130228078
879,2018-03-27,584055,2485963.552682318,278768.0,506407799054489.75,1617939968,44316774118,327545,130555623
880,2018-03-28,579858,2462959.8208407154,292971.0,1.0000000000000011e+27,1514179968,43948072321,322037,130877660
881,2018-03-29,583673,2576814.4452805207,283044.0,1.0000000052886199e+26,1970230016,38016727209,341254,131218914
882,2018-03-30,633616,2327212.0631865575,301150.0,3.5687458961001145e+28,1878130048,38879465944,359552,131578466
883,2018-03-31,584396,1505158.061261906,272109.0,44876248045033.914,1323920000,39066085342,312038,131890504
884,2018-04-01,545141,1268997.2679768023,303651.0,2.3100003461228892e+19,1256930048,37413407420,288947,132179451
885,2018-04-02,598505,1440779.2675372935,302780.0,1.0000203410376177e+18,1102259968,38093277842,319342,132498793
886,2018-04-03,645977,1675678.6054292435,305729.0,3.1162007702596532e+16,1363399936,41105280498,352173,132850966
887,2018-04-04,628441,1571896.465630323,243557.0,3.473762677119486e+59,1287730048,37528933631,323237,133174203
888,2018-04-05,695871,1296821.6802903549,296172.0,1.0979974412508045e+29,1210680064,37802008408,355664,133529867
889,2018-04-06,647981,1318029.6937380205,265026.0,171006735536986.47,967105984,36532478896,336103,133865970
890,2018-04-07,535865,881782.7683202273,326826.0,1278068855871535.2,951475008,38023057371,282010,134147980
891,2018-04-08,595733,1248324.5520450422,311658.0,9.999999999999999e+56,948488000,39530560784,304417,134452397
892,2018-04-09,609799,1558299.7313558457,325696.0,7.38390616707019e+57,1478390016,39343018191,332738,134785135
893,2018-04-10,571388,1266800.1301281028,366294.0,3.1030800000026044e+26,1196000000,40903130396,310045,135095180
894,2018-04-11,609102,1484574.245971443,413241.0,299494515198148.25,1439040000,42521044920,309905,135405085
895,2018-04-12,692606,2265468.020095777,367688.0,2.095015032043634e+19,2519360000,48693844481,362342,135767427
896,2018-04-13,730344,2224428.2081772094,353235.0,3.0000000002421824e+24,2419249920,48683660481,387748,136155175
897,2018-04-14,611188,968581.4523539311,276249.0,2.315841784746324e+59,1519079936,49557725333,304626,136459801
898,2018-04-15,619985,1171252.6132438856,291395.0,1.0000000300308221e+23,1726089984,52555419462,316680,136776481
899,2018-04-16,664402,1398237.1524441242,329974.0,703381532440084.1,1758979968,50534185799,349790,137126271
900,2018-04-17,742823,1448482.1140926392,353026.0,2.110764366510071e+16,1760359936,49728519115,373877,137500148
901,2018-04-18,703293,1749609.6893758196,393482.0,827060393178971.9,1762940032,51904227886,362340,137862488
902,2018-04-19,814318,1815103.3080750164,473648.0,7.000056938524823e+26,2256869888,56178772001,373469,138235957
903,2018-04-20,832220,2177356.7942784936,490375.0,4.631683569492648e+59,2849469952,60922818296,415117,138651074
904,2018-04-21,746104,1699426.5628197927,315148.0,4.87427675214415e+16,2612460032,59913832194,398017,139049091
905,2018-04-22,748858,1261015.945313451,380232.0,1.5052977877119482e+60,2426269952,61556034015,395504,139444595
906,2018-04-23,802870,3093385.1440756866,311497.0,6.947533354238974e+59,2386830080,63617020167,443212,139887807
907,2018-04-24,816357,2719197.45956399,356165.0,5.78960446186581e+59,3581860096,70127342534,437060,140324867
908,2018-04-25,799014,2523798.7095451127,375548.0,1.7294067245500996e+60,4216140032,60955966711,404837,140729704
909,2018-04-26,793873,2027985.3291640128,442018.0,4.053147166601618e+60,2984009984,65663946135,382109,141111813
910,2018-04-27,764479,2105038.8709055944,393213.0,1.6717482883637515e+60,2598129920,64114105428,374563,141486376
911,2018-04-28,775321,1796924.724141333,368923.0,4.631683569492648e+59,2496659968,67759208004,382386,141868762
912,2018-04-29,756651,1661137.943930926,326661.0,5.787406610022144e+59,2740559872,68289153706,372012,142240774
913,2018-04-30,778133,2014081.6509545324,356830.0,5.9065544719955e+59,2853100032,66423712256,408492,142649266
914,2018-05-01,713839,1884620.3961642282,409091.0,1.158920892373162e+59,2678960128,66803233984,377979,143027245
915,2018-05-02,787722,2671525.3904598285,486699.0,1.6582073787642513e+59,2822269952,68159979253,420349,143447594
916,2018-05-03,839586,2869964.9967159694,476377.0,9.515489780647427e+59,4210939904,77340839220,445451,143893045
917,2018-05-04,1000526,2587321.047558374,334031.0,5.78960446186581e+59,3533410048,77960306236,710919,144603964
918,2018-05-05,789261,1737471.6805553716,538961.0,1.1567641282449171e+59,3035040000,81003446783,433238,145037202
919,2018-05-06,691273,1527550.003163826,543686.0,1.0106177638075945e+21,3105570048,78656662788,394628,145431830
920,2018-05-07,789863,2956959.0535013466,382114.0,1.2541981884929303e+59,4316120064,74841655792,405054,145836884
921,2018-05-08,820098,2115395.9744612407,363084.0,5.065903904132583e+58,2920489984,74770813968,421358,146258242
922,2018-05-09,831127,2232331.2666488406,412115.0,5.873138929587656e+57,2877870080,74728439730,426276,146684518
923,2018-05-10,854827,2149148.8970410028,386895.0,8.354324897895448e+58,2748950016,72260117775,420768,147105286
924,2018-05-11,826099,2199023.3643607274,416740.0,1.1506445834037243e+59,3290080000,67535702572,427748,147533034
925,2018-05-12,788487,1606115.695809124,450287.0,2.0100000500127558e+26,2668480000,68192028458,385612,147918646
926,2018-05-13,762439,1186387.1100757243,447098.0,4.8732425171752494e+57,2362500096,72923278119,382697,148301343
927,2018-05-14,801788,2172776.9615179584,346988.0,1.3254417632826753e+59,3005110016,72645181706,440545,148741888
928,2018-05-15,779210,1975146.105368923,417873.0,3732929470820.595,2523069952,70504110201,400892,149142780
929,2018-05-16,807257,1691542.4685388124,419859.0,5.000000000216906e+26,2476130048,70337446111,406480,149549260
930,2018-05-17,835761,1708454.666391711,390779.0,1919497774205688.0,2350619904,66929938612,426383,149975643
931,2018-05-18,831831,1662610.0142873856,393259.0,5.631683569492648e+59,2305740032,69104455849,426633,150402276
932,2018-05-19,846288,1216267.9475370916,392205.0,1.1559999999999999e+49,2021549952,69334147807,413866,150816142
933,2018-05-20,777283,1270947.8413714187,433075.0,1.8800018259892165e+18,2156910080,71224213260,363513,151179655
934,2018-05-21,802211,1659141.3936859886,422345.0,1.157920892373162e+59,2005170048,69631032596,409244,151588899
935,2018-05-22,822409,2213637.5832600635,378071.0,2.676312902079629e+59,2230469888,64517663406,405405,151994304
936,2018-05-23,833377,2740155.272404386,412491.0,3.3066399233014155e+59,2995429888,58139666822,439615,152433919
937,2018-05-24,811167,2120915.9915963598,404467.0,5.991166558118112e+58,2791099904,59962094302,413847,152847766
938,2018-05-25,800838,1819548.3577514652,415870.0,5.565944571459452e+59,2110919936,58477440268,403121,153250887
939,2018-05-26,761932,1330537.1307930653,435228.0,1.5951146080847285e+59,1694300032,58544016481,352251,153603138
940,2018-05-27,776024,1975489.4096796159,410098.0,1.058159861847001e+59,1788790016,57099072056,370235,153973373
941,2018-05-28,861002,2741847.681025132,373883.0,6.397049530260418e+60,2356900096,51463146627,468424,154441797
942,2018-05-29,812183,2242609.388232217,411221.0,1.751234268685962e+59,2330820096,56396587656,399885,154841682
943,2018-05-30,817167,2177414.8992459937,370146.0,1.1440487319349084e+60,2053970048,55829809817,419890,155261572
944,2018-05-31,832842,2276016.1009410946,359945.0,4.140848911095798e+59,1985040000,57643138807,440303,155701875
945,2018-06-01,758242,2479811.0865605352,451344.0,1.2212306269175142e+61,1945890048,57894350583,397607,156099482
946,2018-06-02,768017,1301646.5941890734,471617.0,2.499613007633603e+60,1880390016,59080880117,373421,156472903
947,2018-06-03,809997,1122686.082744141,455208.0,2.6900433579793694e+60,1832550016,61740821846,368774,156841677
948,2018-06-04,807165,2032947.0003113535,435968.0,3.373438894809267e+60,1903430016,59222873880,405519,157247196
949,2018-06-05,780654,2072053.4178632472,426548.0,1.483914946658727e+60,1844269952,60864980395,390515,157637711
950,2018-06-06,754070,2244345.0698698163,392083.0,7.176927879996507e+60,1756530048,60659842641,384193,158021904
951,2018-06-07,775828,2150451.04267874,380738.0,3.1334220519224297e+60,1880140032,60478879395,378068,158399972
952,2018-06-08,720017,2324894.835680395,507238.0,3.429257970596226e+60,1637779968,60080608858,353716,158753688
953,2018-06-09,769427,1194638.7626185229,466779.0,1.6870053217042154e+60,1519309952,59741701633,339375,159093063
954,2018-06-10,771280,1798407.8904402452,459029.0,5.637294078622884e+60,2234880000,52645885461,367771,159460834
955,2018-06-11,768985,2187494.097626749,377432.0,4.725024657494592e+60,1982119936,53337466294,399096,159859930
956,2018-06-12,770199,2979799.036961894,394509.0,7.9241966455064605e+59,1932760064,49702985162,357463,160217393
957,2018-06-13,797637,4104052.1524493494,549857.0,3.3204113262190307e+59,2080130048,47777150787,386120,160603513
958,2018-06-14,765916,4079388.099563274,447485.0,1.0207384893963348e+21,2458650112,52015066663,397470,161000983
959,2018-06-15,763803,3587664.200794058,361516.0,3.1268483496461866e+59,1808269952,49149084090,395155,161396138
960,2018-06-16,639775,1613020.097322801,1487305.0,4.520286097479107e+59,1314109952,50024018701,302698,161698836
961,2018-06-17,648548,1182608.9619797003,376005.0,6.509461390941245e+60,1264870016,50114921288,323832,162022668
962,2018-06-18,695753,1590554.5571857328,405179.0,1.4166743191920524e+59,1513869952,51972519171,347071,162369739
963,2018-06-19,778765,1938156.6604566192,450817.0,2.295044605127147e+58,1726569984,53893191559,377928,162747667
964,2018-06-20,803076,2071551.9244092684,454224.0,3.193863170448328e+59,1596290048,53735032875,378812,163126479
965,2018-06-21,752035,1861910.6414589062,407603.0,3.344823157144021e+32,1462070016,52853921455,376373,163502852
966,2018-06-22,770457,2406367.8109634435,450561.0,6.120249880309839e+60,2226030080,46694859628,402575,163905427
967,2018-06-23,675918,1287804.4487632578,402313.0,2.377190383598617e+59,1651379968,47577076102,338305,164243732
968,2018-06-24,671994,1992232.7414936426,399184.0,4.0939472154308545e+59,2490579968,45897156207,363394,164607126
969,2018-06-25,837265,2413149.253275942,446277.0,1.114941053171799e+32,4007950080,46171165114,452422,165059548
970,2018-06-26,732170,1941364.1419812304,495767.0,6.890402220269543e+59,1356560000,43417898248,377617,165437165
971,2018-06-27,771938,1935680.0586960292,532843.0,1.6878260251913386e+59,1368940032,44389430889,384039,165821204
972,2018-06-28,744784,1802264.6298694,512506.0,1.5276143821036426e+59,1360790016,42391125054,386859,166208063
973,2018-06-29,735092,2171935.2051538024,436065.0,5.5162506769359175e+59,1564499968,43769409548,381648,166589711
974,2018-06-30,632981,1243662.3008911982,736726.0,9.93096223395961e+59,1475939968,45703302056,278945,166868656
975,2018-07-01,622633,1004346.1983623891,842350.0,2.9585109291132763e+59,1511730048,45585861718,235234,167103890
976,2018-07-02,489559,1420587.8545455884,892456.0,1.0725325350081115e+60,1625789952,47747743959,280261,167384151
977,2018-07-03,573532,1803622.3192714527,831975.0,9.097648700896055e+58,1683939968,46637067239,278878,167663029
978,2018-07-04,447112,1551945.463329899,873964.0,1.0782768659643552e+59,1549769984,46960391871,267794,167930823
979,2018-07-05,527586,1652662.3336865127,835656.0,2.812575653277949e+59,1828610048,47682968020,313154,168243977
980,2018-07-06,459075,1599111.4525137271,959541.0,3.547036439102113e+59,1627609984,47652424064,259386,168503363
981,2018-07-07,484105,1116519.1480193294,942778.0,3.20981532708455e+59,1358360064,49436674025,260480,168763843
982,2018-07-08,631505,1269224.9212000084,664433.0,1.195986771036374e+60,1344560000,49191161178,320910,169084753
983,2018-07-09,651926,1748975.808352201,666843.0,9.78437517875218e+59,1533799936,47950212027,316641,169401394
984,2018-07-10,691771,1910868.966312744,631186.0,1.0752838612419779e+60,1789069952,43708241775,309735,169711129
985,2018-07-11,643920,1423058.6763786552,753662.0,1.5311914298760317e+60,1422470016,44934271235,286005,169997134
986,2018-07-12,566058,1307057.8955306802,835953.0,8.279397937761809e+59,1495440000,43288294177,270296,170267430
987,2018-07-13,563317,1246830.0898542986,891607.0,5.1871412609699135e+59,1489670016,43694988769,264640,170532070
988,2018-07-14,508951,929558.4138428874,1022048.0,4.9011661627209743e+58,1235820032,43911193561,264912,170796982
989,2018-07-15,453706,793117.2338677672,973834.0,3.236864675457935e+60,1350160000,45306414380,253566,171050548
990,2018-07-16,703999,1728514.4752031707,523660.0,3.228765104056939e+59,1858680064,48419026521,336848,171387396
991,2018-07-17,701292,1789076.5463865462,524429.0,4.286710030331355e+59,2288100096,50478766285,328725,171716121
992,2018-07-18,746145,2045326.2268752626,462485.0,1.053119172189487e+60,2371559936,48424155624,348449,172064570
993,2018-07-19,734702,1659542.0454633287,457424.0,1.5996682942000382e+60,2068739968,47335899963,331079,172395649
994,2018-07-20,671608,1768585.288274842,337719.0,7.166552746354478e+59,1821350016,45437819522,344351,172740000
995,2018-07-21,620634,1089214.3648931994,316726.0,5.730206952442507e+59,1504310016,46630720739,319276,173059276
996,2018-07-22,675356,1037589.601918475,457259.0,1.4913107232465273e+60,1338589952,46360029757,312487,173371763
997,2018-07-23,758657,1635162.1233271228,418874.0,1.4884883560053985e+60,1596999936,45481301491,335367,173707130
998,2018-07-24,784910,1730049.2399990372,428534.0,1.297943336025161e+60,2287520000,48368209917,367087,174074217
999,2018-07-25,787527,1526443.2222260502,433941.0,4.9344588550113465e+59,1930780032,47683830874,356785,174431002
1000,2018-07-26,725630,1241625.0764307128,451941.0,1.0486271543205013e+60,1621560064,46839932193,356439,174787441
1001,2018-07-27,788715,1359028.6218041938,420418.0,6.255412973224788e+59,1734259968,47417755376,345082,175132523
1002,2018-07-28,703973,796903.0492725335,339203.0,1.1807399101315787e+60,1531890048,47147853886,335563,175468086
1003,2018-07-29,716354,769370.2876910815,427693.0,3.264794671994858e+60,1631910016,47133881666,321798,175789884
1004,2018-07-30,757712,1559479.3237987044,475345.0,1.1198556967101177e+60,2141590000,46175217427,358241,176148125
1005,2018-07-31,745063,2842053.0234208554,446330.0,7.677323603801763e+59,1820680000,43839034237,381034,176529159
1006,2018-08-01,757758,1518269.855621728,452793.0,5.3920628949455435e+59,1888060000,42521937218,369280,176898439
1007,2018-08-02,779928,1604738.4629174662,448850.0,6.110988630866472e+59,1569300000,41709183608,341302,177239741
1008,2018-08-03,753190,1325078.2341499035,459938.0,1.4664094128826278e+60,1722340000,42287977978,353727,177593468
1009,2018-08-04,720548,959347.5238038766,486687.0,1.4529458559163178e+59,1466540000,41183215694,299926,177893394
1010,2018-08-05,704249,894207.763685065,483499.0,1.08944081352643e+60,1396820000,41521715110,311063,178204457
1011,2018-08-06,699536,1230144.5361732042,464953.0,2.214839960795862e+59,1384880000,41139790462,339872,178544329
1012,2018-08-07,636342,1381310.8873029102,267793.0,1.6172978098677148e+59,1828350000,38472420233,358282,178902611
1013,2018-08-08,565663,2066025.85015403,129187.0,3.4302516710762493e+22,2016080000,36091566801,385933,179288544
1014,2018-08-09,538530,1612866.1571409253,126011.0,1.2397995359450923e+59,1616610000,37007391031,361454,179649998
1015,2018-08-10,613892,1829034.2609048868,208928.0,2.679381155387058e+59,1699400000,33834485092,374376,180024374
1016,2018-08-11,657312,1660625.7081747514,387880.0,6.631558350424009e+59,1790370000,32619681420,328140,180352514
1017,2018-08-12,641927,1014074.2685672072,407677.0,1.2613029652651091e+60,1625420000,32368768332,300943,180653457
1018,2018-08-13,694941,2500435.730871653,399224.0,7.707319207702928e+59,1751190000,29024490503,342326,180995783
1019,2018-08-14,690348,3147893.077701576,389143.0,1.4400417688612694e+59,2137850000,28263969132,350065,181345848
1020,2018-08-15,648565,2333286.118857991,388520.0,1.0496944020215417e+60,1878150000,28617473116,317083,181662931
1021,2018-08-16,716732,1551492.362781218,398074.0,3.2911800005593025e+59,1552970000,29199228646,330449,181993380
1022,2018-08-17,607270,1867971.313434584,275532.0,8.474188853037907e+59,1995460000,32011921283,357871,182351251
1023,2018-08-18,627522,1112919.1415440103,457517.0,1.1472759283278319e+60,1764020000,29998584852,271669,182622920
1024,2018-08-19,599660,787206.2395255124,392234.0,2.2298921047726807e+32,1447910000,30514025774,266183,182889103
1025,2018-08-20,663769,1457323.5093849297,412824.0,1.298987833162027e+60,1413790000,27829775231,326890,183215993
1026,2018-08-21,605639,1470787.819603774,470274.0,9.141701800993467e+59,1164120000,28609531323,293857,183509850
1027,2018-08-22,594918,1738821.3529965691,384032.0,1.6010245936840306e+60,1507660000,27539119679,294905,183804755
1028,2018-08-23,599557,1466367.6598429629,415138.0,3.5700153471928054e+59,1271160000,28129662664,307950,184112705
1029,2018-08-24,596227,1433980.5196085218,413077.0,2.100448374134809e+59,1450170000,28730705349,308802,184421507
1030,2018-08-25,577239,1079601.2384329524,452521.0,4.642813467361152e+59,1208360000,28399212923,296771,184718278
1031,2018-08-26,574072,982105.6607672458,384942.0,7.509228030975068e+58,1206650000,27953028997,298438,185016716
1032,2018-08-27,645935,1614582.0532926829,592615.0,2.852774881930383e+59,1406790000,29015874948,313430,185330146
1033,2018-08-28,613844,1453566.0468473274,534197.0,2.5250658169969594e+59,1513350000,30128902937,332693,185662839
1034,2018-08-29,546841,1566254.07254571,451397.0,1.8999317681318008e+59,1474460000,29404459725,285482,185948321
1035,2018-08-30,592847,1433665.5484505894,436910.0,2.8056626389043927e+61,1513100000,28881058148,304870,186253191
1036,2018-08-31,577258,1506140.2991726594,397094.0,4.718777823110429e+61,1411910000,28774922508,310771,186563962
1037,2018-09-01,656254,1170891.6986581383,388869.0,7.87957144730163e+60,1546630000,30035327410,323016,186886978
1038,2018-09-02,620267,917763.5117844184,400414.0,2.7981595484803818e+60,1321050000,29942718225,300784,187187762
1039,2018-09-03,631429,1796437.368554297,391572.0,1.358980613059978e+61,1394490000,29428616901,328112,187515874
1040,2018-09-04,589521,2931159.1897595515,350809.0,1.4775904278327015e+61,1554870000,29074743101,317010,187832884
1041,2018-09-05,626957,2478453.739496974,352765.0,1.2345773945476886e+61,2390390000,23646371777,339575,188172459
1042,2018-09-06,588959,3044532.899118216,439448.0,4.009759591069574e+60,2097310000,23435751842,350841,188523300
1043,2018-09-07,582184,2572015.6393012363,616803.0,3.434365207854049e+60,1678260000,22115522904,306747,188830047
1044,2018-09-08,543337,2119995.649899332,372714.0,6.792301516412502e+60,1517200000,20159309964,269778,189099825
1045,2018-09-09,565631,2183293.774446179,342138.0,8.115874179602697e+60,1585980000,20058708800,279543,189379368
1046,2018-09-10,561611,2470279.7169796103,347711.0,6.821327590299882e+60,1502960000,20078523984,309385,189688753
1047,2018-09-11,557317,2499660.1032640985,360628.0,1.5207527979935946e+61,1568900000,18858381966,298933,189987686
1048,2018-09-12,570673,3783920.506230772,361506.0,2.093528119878946e+61,1874850000,18685319378,308501,190296187
1049,2018-09-13,555753,2343978.952046614,370873.0,2.566694637645016e+61,2330720000,21545775837,313980,190610167
1050,2018-09-14,514394,2136815.568815905,436969.0,1.432076327078022e+61,2232190000,21590366996,277941,190888108
1051,2018-09-15,479695,1440524.3027020316,430458.0,1.553953627961838e+61,1670490000,22749647321,250718,191138826
1052,2018-09-16,458432,1218379.5502970885,435270.0,2.235191782929396e+61,1502260000,22500748646,236190,191375016
1053,2018-09-17,553720,1946847.7421815782,434508.0,1.4429477846598353e+61,2019910000,20187902505,280539,191655555
1054,2018-09-18,500513,1819373.6286984985,413739.0,1.3987186284058637e+61,1800640000,21426628309,267351,191922906
1055,2018-09-19,507255,1549998.364794647,270696.0,1.1086368911900403e+61,1733330000,21430323331,285509,192208415
1056,2018-09-20,498146,1892442.8475608043,411815.0,1.2860180919582818e+61,1782070000,22927300808,281847,192490262
1057,2018-09-21,544686,2912837.171706304,368890.0,5.025356223322662e+60,2836200000,25177561991,321328,192811590
1058,2018-09-22,470309,1570271.2346372593,387040.0,4.100453615880732e+60,1921820000,24559189741,261997,193073587
1059,2018-09-23,468627,1392506.7851904484,395113.0,4.968691591723593e+61,1693470000,24957339670,251463,193325050
1060,2018-09-24,480337,1889950.324683693,409942.0,1.2353483843609455e+61,1748740000,23368514475,263942,193588992
1061,2018-09-25,519108,1882879.4549134404,439639.0,5.347012894643453e+60,2120360000,22328327983,277575,193866567
1062,2018-09-26,493507,1845165.946592205,456063.0,3.0600864732669015e+60,1756100000,22061164303,266326,194132893
1063,2018-09-27,504047,1666302.3801744513,433901.0,4.022548064044292e+60,2030320000,23358464739,279785,194412678
1064,2018-09-28,500407,1692258.9218244723,389028.0,6.213247175553833e+60,2018120000,22740233568,276247,194688925
1065,2018-09-29,434315,1427713.3835032487,284881.0,3.26807181827976e+60,2208720000,23688983896,241164,194930089
1066,2018-09-30,479351,1350892.4585847696,385148.0,4.636248338956058e+60,1765560000,23817805502,262183,195192272
1067,2018-10-01,476308,1253341.0653251298,394481.0,4.609705817756714e+60,1597500000,23609728018,261074,195453346
1068,2018-10-02,490262,1097886.873358382,357439.0,6.848927961416969e+60,1542080000,23247403474,253929,195707275
1069,2018-10-03,559006,1602167.7950718391,380267.0,2.0493262152716653e+61,1683930000,22567089086,271825,195979100
1070,2018-10-04,559181,1599004.368662278,411941.0,6.453784756964923e+60,1479500000,22748580859,284860,196263960
1071,2018-10-05,595361,1483483.2968702614,409875.0,3.88437081586773e+60,1547330000,23304234601,289976,196553936
1072,2018-10-06,596865,1084119.3523806313,363614.0,3.258226605828111e+60,1505070000,23054817089,299107,196853043
1073,2018-10-07,497767,976591.4304497304,298647.0,1.6935341350990608e+61,1470480000,23161767973,249729,197102772
1074,2018-10-08,542842,1629650.165477405,311598.0,1.1311356521895862e+61,1470740000,23487673000,273519,197376291
1075,2018-10-09,537028,1422466.7437124029,375650.0,5.315571882490337e+60,1405130000,23361891401,253262,197629553
1076,2018-10-10,516772,1488880.3502579762,263652.0,1.1744839420777244e+61,1384040000,23139713070,267921,197897474
1077,2018-10-11,570525,3099520.8356246166,294199.0,2.873340421421131e+61,2167620000,19426181717,288837,198186311
1078,2018-10-12,562140,2019510.4752387998,655098.0,1.8884853586703688e+61,1487900000,20171157774,268472,198454783
1079,2018-10-13,541797,1192920.6573452626,337899.0,2.8723622368482937e+61,1167610000,20494529773,251449,198706232
1080,2018-10-14,511719,1158536.9786671768,329840.0,8.221238335949452e+60,1169260000,20075397007,239054,198945286
1081,2018-10-15,562011,3351255.5719791455,302054.0,2.58626120595135e+61,2865830000,21514574462,289480,199234766
1082,2018-10-16,575450,2247577.477301577,313001.0,5.184058553987158e+60,1532280000,21561538445,292752,199527518
1083,2018-10-17,580354,1930123.7195291417,305312.0,3.127845850533928e+61,1444130000,21254117736,291934,199819452
1084,2018-10-18,565791,2354432.2662739893,395000.0,9.517411169142689e+60,1365860000,20875341345,281620,200101072
1085,2018-10-19,601119,1674196.6207214596,346221.0,9.782365717191945e+60,1264480000,20917973393,274738,200375810
1086,2018-10-20,534080,1437912.7157273926,394152.0,4.0200910827634346e+60,1238780000,21097037289,267820,200643630
1087,2018-10-21,508014,1964845.4383607483,341648.0,2.2200027574166457e+60,1190300000,21071630786,247016,200890646
1088,2018-10-22,577314,1594848.2554631606,381227.0,6.942026532600649e+60,1328980000,20962977292,282684,201173330
1089,2018-10-23,556231,1712471.770986974,343256.0,4.122724598361426e+61,1237490000,20997181867,282228,201455558
1090,2018-10-24,532709,1642648.0995037642,285784.0,2.253875743607937e+61,1102220000,20951603018,290389,201745947
1091,2018-10-25,537236,2211998.9407806313,316274.0,1.813563178820293e+61,1102900000,20839259066,283604,202029551
1092,2018-10-26,551218,1728495.5034160067,312526.0,2.9358663222847106e+60,1161310000,20906130835,292355,202321906
1093,2018-10-27,499165,995228.4993106576,344069.0,9.139197189749728e+60,1084810000,21000852987,249116,202571022
1094,2018-10-28,509862,1016640.0910960822,376215.0,1.6007052224780205e+60,1139140000,21123907349,261101,202832123
1095,2018-10-29,614695,1985917.4124619497,356516.0,5.227308867732806e+61,1517230000,20292811278,313897,203146020
1096,2018-10-30,608397,1669210.5293447552,368437.0,4.4252228118975836e+61,1363500000,20328580026,302209,203448229
1097,2018-10-31,585707,1745738.8431348247,371388.0,3.5009797071264106e+60,1442380000,20314628127,297502,203745731
1098,2018-11-01,589096,1622419.0718184519,362090.0,2.340501288224234e+61,1336700000,20472105764,290816,204036547
1099,2018-11-02,548534,1884059.66984665,330740.0,3.4584712944638694e+61,1451870000,20657629735,268272,204304819
1100,2018-11-03,505015,1094559.9142745472,335057.0,1.6206922849452996e+61,1307150000,20615439151,251769,204556588
1101,2018-11-04,510848,1526441.635384051,279432.0,6.791467664489219e+60,1749300000,21371416840,248727,204805315
1102,2018-11-05,582354,2356288.723306183,263366.0,1.838629484948501e+61,1613510000,21540996877,299655,205104970
1103,2018-11-06,597166,1866090.2224241127,347267.0,2.0167640659675912e+61,1856940000,22445690692,293138,205398108
1104,2018-11-07,564602,2131707.742350845,315076.0,1.4215510489281275e+61,1927830000,22383497662,281828,205679936
1105,2018-11-08,555392,1729889.4478773305,324125.0,1.745310472129721e+61,1769080000,21877424057,276866,205956802
1106,2018-11-09,547848,1658236.8045786782,310701.0,1.7785894946079317e+61,1554750000,21659329261,285925,206242727
1107,2018-11-10,489120,1110310.4527520859,341554.0,1.4948359143135552e+61,1377760000,21917195708,247536,206490263
1108,2018-11-11,527799,1120563.5870187248,409364.0,1.772008651115544e+61,1501600000,21798464881,261168,206751431
1109,2018-11-12,571162,1866106.2484202643,331426.0,3.106729168359858e+62,1452380000,21707637540,287415,207038846
1110,2018-11-13,553590,1704504.7366050957,300758.0,4.854710915299929e+62,1610260000,21341261802,278454,207317300
1111,2018-11-14,582181,2985472.2359286672,303733.0,3.2966472374082807e+61,2595330000,18721032761,304067,207621367
1112,2018-11-15,563051,3164274.7923297104,248861.0,1.2279846687773101e+61,2638410000,18663659629,299790,207921157
1113,2018-11-16,552107,2240481.4629836828,278176.0,1.7167784599414596e+62,2015330000,18086156169,274094,208195251
1114,2018-11-17,505581,1397174.8139018908,274185.0,6.618480179569185e+60,1832800000,17968221715,247366,208442617
1115,2018-11-18,484801,1899243.9433552627,255029.0,2.9090897593984385e+60,1810920000,18288411984,234181,208676798
1116,2018-11-19,622942,4848644.129215199,270415.0,4.114988916422747e+62,2745160000,15410551811,335389,209012187
1117,2018-11-20,625752,5652301.423843689,290180.0,3.9391906713379637e+62,3134410000,13467303239,322294,209334481
1118,2018-11-21,579531,3828834.7385142706,334311.0,2.0293011814490924e+62,2685930000,14127420909,284293,209618774
1119,2018-11-22,568895,2635315.2231770568,322551.0,2.0047331857655885e+62,1792150000,13097009562,270468,209889242
1120,2018-11-23,559992,3050333.342702861,290441.0,4.0153145684814593e+62,1998010000,12747016419,274539,210163781
1121,2018-11-24,497091,2275106.910729926,273560.0,9.750144107767403e+60,1800960000,11735901799,243754,210407535
1122,2018-11-25,529038,3962260.765368654,287853.0,1.090132271931964e+60,2466750000,12043900588,274261,210681796
1123,2018-11-26,557388,3425107.1680002343,315084.0,2.869857725330116e+60,2139490000,11206775318,279997,210961793
1124,2018-11-27,565825,2846515.1627307986,351313.0,3.2774560469050285e+60,2320010000,11382216773,275659,211237452
1125,2018-11-28,622580,3365385.4054208645,320834.0,4.5757303444491185e+60,2673470000,12670491119,301080,211538532
1126,2018-11-29,555591,3624519.1479855916,292023.0,7.502851952580398e+61,2196099151,12166285642,273765,211812297
1127,2018-11-30,599039,17348022.506624013,377006.0,4.337863970051596e+61,2020748396,11716096076,310944,212123241
1128,2018-12-01,525757,15485294.09762568,268425.0,1.4161096477874683e+62,2131475768,12284117522,259530,212382771
1129,2018-12-02,492410,1415475.2802516508,269829.0,1.7410495039079944e+61,1856199149,12053770487,246085,212628856
1130,2018-12-03,548100,2278750.7856664686,298375.0,2.1634537646087365e+62,1772756193,11282911404,276270,212905126
1131,2018-12-04,565202,2270774.406046138,290875.0,2.0041269514624567e+62,1748116495,11418617063,269015,213174141
1132,2018-12-05,595937,2885681.890783716,336028.0,2.739683587637306e+62,1990157607,10618884099,286563,213460704
1133,2018-12-06,590923,3817878.6966566197,335952.0,1.880452327509181e+61,2310716932,9510417097,281918,213742622
1134,2018-12-07,572417,4901105.622965143,295113.0,1.0483325288547907e+62,2554304530,9671177427,302099,214044721
1135,2018-12-08,552651,2708162.470152271,321549.0,5.446140120103854e+60,1855759401,9555327946,289208,214333929
1136,2018-12-09,507555,2367196.4869825924,317205.0,5.6733389084027995e+60,1875567180,9866414732,259977,214593906
1137,2018-12-10,555379,2506396.8650583737,393170.0,1.2235257219437513e+61,1756437577,9509816315,287764,214881670
1138,2018-12-11,536006,2571755.031059768,372776.0,1.4326884659006454e+61,1707497898,9227301064,252889,215134559
1139,2018-12-12,533920,2340898.816377128,380687.0,4.9201201323513554e+60,1533050103,9400044026,251854,215386413
1140,2018-12-13,565689,2995669.7802113043,344147.0,1.0739202675503362e+61,1754475622,8981108543,261740,215648153
1141,2018-12-14,567306,2705738.1137522184,325275.0,6.714572224014672e+60,1651491877,8751209554,269552,215917705
1142,2018-12-15,551916,1824198.7908380148,336437.0,9.749083610597356e+61,1496176898,8766638124,270774,216188479
1143,2018-12-16,516697,1776105.3788093163,381252.0,6.2497794189885596e+60,1565817037,8853567311,264664,216453143
1144,2018-12-17,570051,3456954.3500849046,344391.0,4.634001188117574e+60,2101453024,9880456239,276020,216729163
1145,2018-12-18,556320,3230807.2770929625,334761.0,1.9179891700066186e+61,2277514076,10503295749,267745,216996908
1146,2018-12-19,597824,4345345.122914198,325132.0,4.004694306835409e+60,2456482115,10521416481,290955,217287863
1147,2018-12-20,602429,4415797.854773066,348328.0,1.3742536400907705e+62,3063842618,12076674310,291068,217578931
1148,2018-12-21,606526,4512019.720334686,331452.0,2.2740762999564032e+62,2632539990,11380357569,283767,217862698
1149,2018-12-22,495551,2106318.5829060464,328218.0,3.402138634743328e+61,2338772939,12137481655,237456,218100154
1150,2018-12-23,543655,2965362.742738163,290218.0,1.3858426026789907e+62,3579715061,13595887732,272737,218372891
1151,2018-12-24,615551,3927892.7522500814,345910.0,4.986403425823841e+61,4370343387,14583457939,304343,218677234
1152,2018-12-25,535001,2416799.100772578,293379.0,2.4204384983878905e+61,3298280609,13505089290,266610,218943844
1153,2018-12-26,560047,2142391.088846817,357279.0,1.40430443153139e+61,2720469126,13717858346,266296,219210140
1154,2018-12-27,548411,2831932.7891787835,396569.0,9.117030171449429e+60,2612804378,12129493222,262518,219472658
1155,2018-12-28,572189,2993138.6818494373,416168.0,2.6507310904544696e+61,3130201009,14324511544,274592,219747250
1156,2018-12-29,543746,3781918.095448838,357752.0,1.1098603880417898e+61,3169029972,14365797196,270689,220017939
1157,2018-12-30,460395,1625233.573386157,314598.0,7.382083970432263e+60,2660086834,14560066114,243220,220261159
1158,2018-12-31,522040,2099883.0902997735,396847.0,1.0060622106792344e+61,2358360234,13886837730,241663,220502822
1159,2019-01-01,448168,1666783.0154436028,292462.0,4.245749403509647e+60,2258709868,14665318370,221312,220724134
1160,2019-01-02,589959,2743259.2234950685,363826.0,5.833121871136384e+60,3328240369,16150049902,260849,220984983
1161,2019-01-03,596620,2499110.277261625,348861.0,1.8044721944060738e+62,2676164880,15536849936,256708,221241691
1162,2019-01-04,549398,3822913.381812099,323037.0,4.122375812994908e+62,3126192535,16107068093,257650,221499341
1163,2019-01-05,511189,4175182.3837036733,311610.0,4.2266420113905395e+60,3338211928,16219974745,243792,221743133
1164,2019-01-06,487372,2405703.893897147,299153.0,1.3962279243677345e+61,3231294371,16442429109,242342,221985475
1165,2019-01-07,550964,2628749.1515185134,329869.0,1.2299894080621557e+62,2712108388,15814868678,279315,222264790
1166,2019-01-08,553367,2343173.2792511005,314010.0,9.272772047829342e+61,2459808140,15677889902,282954,222547744
1167,2019-01-09,558847,2195157.993590676,313179.0,3.600532941597707e+62,2369241197,15726845711,277920,222825664
1168,2019-01-10,582839,3158286.6449419986,329419.0,1.1648013076827553e+61,3397734456,13416263931,282346,223108010
1169,2019-01-11,541838,3886696.71717949,326462.0,1.8010110960480097e+62,2667585234,13306214134,271955,223379965
1170,2019-01-12,452707,1486761.266778286,263874.0,2.7911850079736066e+61,2212109224,13143426379,224333,223604298
1171,2019-01-13,481347,1775833.075410378,280251.0,2.775910921534745e+61,2268263944,12199288487,233168,223837466
1172,2019-01-14,577239,3460885.6293427586,261695.0,8.563514867128943e+60,2798085735,13471754802,308749,224146215
1173,2019-01-15,539896,2386483.5593507863,258418.0,4.937951060100258e+60,2735449164,12739543688,285979,224432194
1174,2019-01-16,507687,2649870.4275623523,267333.0,3.86542942888314e+61,2746469340,12899812275,243232,224675426
1175,2019-01-17,517082,2158330.9932687283,301673.0,3.7227168337112164e+60,2594091285,12922347330,238074,224913500
1176,2019-01-18,538899,1768855.184630587,326810.0,8.883024901998114e+60,2305389800,12639234713,243829,225157329
1177,2019-01-19,539125,1460993.3392139254,336231.0,6.219438710005996e+60,3048261797,13007954846,236324,225393653
1178,2019-01-20,537705,1721295.657821017,363999.0,4.894933210970258e+60,2964108269,12483136112,213944,225607597
1179,2019-01-21,582751,1837735.6019358581,373022.0,3.3385999766843545e+60,2421720343,12242940197,244836,225852433
1180,2019-01-22,605558,1840236.4207521954,417421.0,3.154667782832039e+60,2552507405,12410972241,231006,226083439
1181,2019-01-23,533819,1976588.5054409052,286449.0,1.7415974546258783e+61,2556952198,12277481872,245977,226329416
1182,2019-01-24,520130,2377266.6662962963,315709.0,5.0370593315976026e+60,2520843420,12269992351,239100,226568516
1183,2019-01-25,504903,1967967.8132517675,316076.0,5.565953884402986e+60,2606881898,12168932300,244280,226812796
1184,2019-01-26,464380,1289843.866628101,332795.0,4.192170972946258e+60,2412181169,12182338148,219867,227032663
1185,2019-01-27,488814,1868327.2106089233,301630.0,8.30389785657339e+60,2775888287,11861671822,243014,227275677
1186,2019-01-28,568564,3251171.890559629,309401.0,5.195134071086408e+60,3366895505,11150461958,293747,227569424
1187,2019-01-29,566026,2283131.498855837,351978.0,4.067607988607058e+60,2900418606,11048347342,261139,227830563
1188,2019-01-30,555347,2371844.8744742544,327049.0,4.357229596676187e+60,2874370355,11396282341,258763,228089326
1189,2019-01-31,517057,2356031.4048378244,318240.0,1.7003761900208072e+60,2828796031,11204735502,244543,228333869
1190,2019-02-01,498856,1955521.7988200684,300307.0,1.5657582492823361e+60,2541271519,11263815610,237549,228571418
1191,2019-02-02,450314,1220412.4887167,288496.0,4.3541207322601e+60,2385157838,11560765573,213028,228784446
1192,2019-02-03,424378,1298746.1821284534,254682.0,1.1186254573031151e+61,2519334757,11254870706,190882,228975328
1193,2019-02-04,416394,1027949.5096801243,273142.0,4.764434271618021e+60,2491888675,11290969364,184308,229159636
1194,2019-02-05,414815,988597.4596344787,227117.0,4.5059686683386384e+60,2515863999,11253035388,189552,229349188
1195,2019-02-06,429065,1759347.9952708697,238156.0,7.664282395719165e+60,2593048199,10990266833,197243,229546431
1196,2019-02-07,428676,1448386.3394280984,242126.0,8.981896749215137e+60,2326764622,10951652648,197131,229743562
1197,2019-02-08,471952,2153525.790982367,264847.0,1.8990524427627342e+60,3656841347,12496945336,222877,229966439
1198,2019-02-09,417129,1158250.364848722,268578.0,3.774388688507973e+60,2884650400,12515870173,198689,230165128
1199,2019-02-10,381151,1449653.7740704492,224038.0,2.3710398541406546e+60,3148766590,13080881910,185342,230350470
1200,2019-02-11,429007,1910661.878298314,236446.0,3.8803680697082176e+60,3222473887,12714795026,204473,230554943
1201,2019-02-12,438111,1539636.5134885695,265851.0,1.180096023971167e+61,3149576429,12849965121,208665,230763608
1202,2019-02-13,491354,1805205.143145069,295646.0,1.7224636518202987e+60,3386585799,12849605819,212339,230975947
1203,2019-02-14,474782,1668224.5494226913,303573.0,3.386398730060441e+60,3331701628,12729213675,209823,231185770
1204,2019-02-15,468599,1589138.4148451476,318043.0,3.664939584639037e+60,3021741615,12805280766,211866,231397636
1205,2019-02-16,454309,1080803.0488486495,274711.0,2.337596673192155e+60,2905833287,12928550184,205923,231603559
1206,2019-02-17,447945,1755070.5892680797,274688.0,3.2904591423899e+60,4236081130,14014695490,198999,231802558
1207,2019-02-18,512455,3008143.8665040415,299348.0,1.7042479524574062e+61,5387525773,15327852479,257534,232060092
1208,2019-02-19,533602,2774298.889979758,333337.0,4.3575648601092126e+60,5310842625,15250901019,252163,232312255
1209,2019-02-20,530268,2237875.159951833,353402.0,3.567126731076239e+60,4500094965,15694462393,245900,232558155
1210,2019-02-21,544817,2147913.8147403356,343152.0,6.033400431049472e+60,3995766856,15337145738,226233,232784388
1211,2019-02-22,530839,2112055.760734785,368103.0,1.3045001025942805e+61,3731099284,15649961167,226275,233010663
1212,2019-02-23,476225,1532488.8023076488,357984.0,2.6776808000748123e+60,4519468458,16670632412,222673,233233336
1213,2019-02-24,540201,2881956.3108056653,339658.0,1.1545314139288334e+60,5957715043,14263873721,237469,233470805
1214,2019-02-25,573756,3727042.449109291,328577.0,1.7859479622862607e+60,4914392068,14682597926,248785,233719590
1215,2019-02-26,553925,1884161.3615612013,299181.0,1.4024940063374233e+61,3791292839,14502464167,242624,233962214
1216,2019-02-27,539516,2924685.8065832453,307275.0,7.210227204103713e+60,4469776860,14298070644,243936,234206150
1217,2019-02-28,541458,2358902.249606886,371102.0,6.200718431522718e+60,4535438953,14365118213,268377,234474527
1218,2019-03-01,547622,1857763.8112373874,427933.0,1.2066292761332004e+61,3756124824,14335957425,239809,234714336
1219,2019-03-02,526912,1486811.9665855626,362811.0,6.744328977256439e+60,3747176425,14103698392,228170,234942506
1220,2019-03-03,492382,1699702.856521398,340493.0,9.838004955019224e+60,3454374053,13900679027,213765,235156271
1221,2019-03-04,620211,2511005.1948302505,457468.0,8.581385234547526e+60,4008171341,13432896659,249416,235405687
1222,2019-03-05,598085,2338898.6410888475,415534.0,1.864132418926712e+61,4764849990,14492117352,250883,235656570
1223,2019-03-06,578932,2206991.2774338378,386942.0,1.2194476759831614e+61,4589054219,14590867639,255590,235912160
1224,2019-03-07,572685,2131033.2110879063,365208.0,1.0063759664688125e+61,4339206292,14513398954,258824,236170984
1225,2019-03-08,562361,2411760.2585415225,388018.0,5.842862288405083e+60,4678816794,14209542041,255569,236426553
1226,2019-03-09,555854,1826967.814899081,339096.0,8.806422563516104e+60,5011918715,14509873018,251383,236677936
1227,2019-03-10,484038,1721442.499663157,300991.0,1.0710115782627058e+61,4578438499,14384860876,220634,236898570
1228,2019-03-11,536412,2472651.833320027,355487.0,1.074689774680669e+61,4689807419,14079044648,241130,237139700
1229,2019-03-12,564306,2368013.6678898204,319391.0,1.6024691341122163e+61,4709988000,14144929392,265426,237405126
1230,2019-03-13,573281,2068256.4220131047,405203.0,1.0632653510866815e+61,4265162099,14022610219,260190,237665316
1231,2019-03-14,573828,2287044.0827162657,378279.0,1.5957105900388544e+61,4476532147,14071628064,260603,237925919
1232,2019-03-15,553012,2189635.5504046152,367855.0,1.7068876945138107e+61,4506861856,14492364551,258114,238184033
1233,2019-03-16,504183,1928045.3180855894,308180.0,2.397896824100964e+61,4839003569,14989691491,238728,238422761
1234,2019-03-17,494872,1752563.1452852266,268069.0,1.1011179065317916e+61,3827157729,14739201597,230056,238652817
1235,2019-03-18,573940,2598720.1406308375,397702.0,8.489080365164091e+60,4551739879,14675181094,270090,238922907
1236,2019-03-19,635940,1902977.6702362015,477970.0,5.99120101335512e+60,4251488129,14797612389,278448,239201355
1237,2019-03-20,630313,2894599.018382317,394942.0,8.140253960563181e+60,4664134462,14817151375,294196,239495551
1238,2019-03-21,618318,2497007.022139651,455577.0,1.7503559877960643e+61,5087247796,14392427839,279243,239774794
1239,2019-03-22,628700,2079060.1599157562,424009.0,8.127092864826494e+60,4490899266,14451740115,296334,240071128
1240,2019-03-23,561778,2564989.6730194227,375912.0,5.0577867534804826e+61,4436568613,14565143357,274286,240345414
1241,2019-03-24,549073,1785341.9540604607,330276.0,2.028115562782646e+61,4266845458,14434995337,266479,240611893
1242,2019-03-25,648670,2876368.630629547,340802.0,2.0292752698837323e+61,4480516753,14230733149,322320,240934213
1243,2019-03-26,629010,2553285.2401012285,357515.0,1.7068082563199718e+61,4499271679,14277816266,313646,241247859
1244,2019-03-27,625948,2299587.8731699972,451527.0,1.2216286880339689e+61,5228240093,14862394451,289819,241537678
1245,2019-03-28,634367,2334977.1713846177,362486.0,1.1776313716480315e+61,4163212475,14698609599,293145,241830823
1246,2019-03-29,640352,2594352.069661528,370918.0,1.4036633153221672e+61,5125602702,15025361637,292505,242123328
1247,2019-03-30,667967,2525373.841516119,444292.0,3.535562170363598e+60,5144662127,14984615423,285309,242408637
1248,2019-03-31,646230,2166816.131000237,451320.0,4.091770872589148e+60,4249050197,14925533137,264047,242672684
1249,2019-04-01,687574,2450268.9332472314,428831.0,5.147211869078356e+60,4611999536,14960828861,332984,243005668
1250,2019-04-02,758900,4117962.4741672515,406478.0,8.50043038395497e+60,9826645698,17297572365,379229,243384897
1251,2019-04-03,746605,4168533.4902086984,387158.0,6.69382906813108e+60,10622456246,17035703564,362916,243747813
1252,2019-04-04,673520,2912393.5538660376,402153.0,6.990472787202816e+60,7953123529,16678477300,303249,244051062
1253,2019-04-05,621924,2695547.3530862783,336622.0,9.257384321010815e+60,7531316908,17468192986,301478,244352540
1254,2019-04-06,559039,1872144.527433142,286357.0,5.6297200306111124e+60,7167016221,17516082778,276767,244629307
1255,2019-04-07,572886,2408065.1991049815,288349.0,1.2076939088921194e+61,7596176020,18424576820,292434,244921741
1256,2019-04-08,668000,3798031.606722731,352047.0,1.3509716686978734e+61,9304964610,19031640376,341583,245263324
1257,2019-04-09,656914,3355275.6452301973,356743.0,2.3309216827948023e+61,7632529578,18596496042,335369,245598693
1258,2019-04-10,674070,2849597.4368782365,350922.0,5.670384548219727e+60,7856924879,18728058767,320172,245918865
1259,2019-04-11,729032,2944764.4247199153,367611.0,9.21007122649713e+60,7859383417,17479876008,346995,246265860
1260,2019-04-12,694793,2516334.9187186393,378631.0,1.463286460787369e+61,6237185309,17401765647,362885,246628745
1261,2019-04-13,614291,1551208.6411557137,339556.0,4.3406357635435454e+60,4959301561,17380468169,311764,246940509
1262,2019-04-14,551055,1730106.6313862235,339689.0,2.5120556891348462e+61,4846298303,17734050269,263850,247204359
1263,2019-04-15,622058,2555474.2721559117,316304.0,3.0017161570680533e+60,5672311824,17074367783,312796,247517155
1264,2019-04-16,656461,2220433.7374111917,359040.0,1.3441930321812932e+61,5180105341,17715913572,305069,247822224
1265,2019-04-17,681896,2236032.783761516,377426.0,7.115542581659881e+60,5596102715,17647086048,304814,248127038
1266,2019-04-18,697650,2635140.9751256593,432648.0,6.772293862931701e+60,6971581464,18374913022,309125,248436163
1267,2019-04-19,693183,2311859.1285961997,388779.0,2.3465079607010714e+61,6541053061,18366130180,315243,248751406
1268,2019-04-20,686824,1880443.335617121,364782.0,5.583214601876324e+60,6142567812,18373023202,338971,249090377
1269,2019-04-21,631190,2009279.2073170086,406791.0,9.00782045706976e+60,6005571688,17983602095,303863,249394240
1270,2019-04-22,719306,2409606.606712845,472648.0,6.167072522034731e+60,6094878077,18179292263,338287,249732527
1271,2019-04-23,729268,2751025.1118615023,448086.0,5.570092008575768e+60,7097827092,18136462572,349195,250081722
1272,2019-04-24,668917,3486487.6703641773,450041.0,1.0497271639210117e+61,7351304156,17544029659,333316,250415038
1273,2019-04-25,680812,3159999.3804825814,349466.0,1.0661579639358128e+61,6820332362,16343573973,309011,250724049
1274,2019-04-26,661061,4528370.269104238,375775.0,1.0280538565683984e+61,7505283355,16545462357,308625,251032674
1275,2019-04-27,562687,1917636.424937486,294022.0,8.520053573821543e+60,5863109118,16768575998,259952,251292626
1276,2019-04-28,593482,2334069.532774202,369487.0,8.07701112433895e+60,5379894433,16650076837,269047,251561673
